Aal=угорь
Abart=разновидность
Abbauhammer=отбойный молоток
abbrennen=сжигать
abdichten=конопатить
Abdruck=отпечаток
Abend=вечер
Abendessen=ужин
Abenteuer=приключение
aber=но
Aberglaube=суеверие
aberglдubisch=суеверный
abfahren=отбывать
Abfahrt=отправление
Abfallbehдlter=урна
Abfдlle=отбросы
Abgabe=подача
abgeleitet=производительный
abgerissen=отрывистый
abgetragen=изношенный
abgleiten=соскальзывать
Abgrund=бездна
Abhang=склон
abhдngen von=зависеть от
abhдngig=зависимый
Abhдngigkeit=зависимость
abkьrzen=сокращать
abladen=выгружать
ablegen=откладывать
ablehnen=отвергать
ablenken=отвлекать
abnehmen=отбирать
Abolizionist=аболиционист
Abordaosдbel=абордажная сабля
Absatz=каблук
abschaffen=отменять
Abscheu=омерзение
abscheulich=отвратительный
Abschied=прощание
Abschleppseil=буксирный канат
Abschneiden=резание
Abschnitt=раздел, глава
abseits=в стороне
Absender=отправитель
Absicht=намерение
absichtlich=преднамеренно
absolvieren=окончить учебу
absondern=изолировать
Absorbens=абсорбент
Absorption=поглощение
Absprache=договоренность
absprechen=оспаривать
Abstellraum=кладовая
abstimmen=голосовать
Abstimmung=голосование
Abstraktion=отвлечение
Abstrich=мазок
Abteil=купе
Abteilung=отдел
abtreten=уходить в отставку
abwarten=выжидать
abwechselnd=поочередный
Abweichung=отклонение
Abwesende=отсутствующий
abwischen=стирать
Abzeichen=значок
abziehen=вычесть
Abzug=тяга
Abzweigung=ответвление
ach=ах
Achat=агат
Achse=ось
Achselhцhle=подмышка
acht=восемь
Achteck=восьмиугольник
Achtung=внимание
achtungsvoll=почтительный
achtzehn=восемнадцать
Acker=акр
Ackerboden=пахотная земля
Ackerkrume=пахотный слой почвы
addieren=складывать, добавлять
additiv=аддитивный
Adjektiv=прилагательное
Adler=орел
Administrator=администратор
Admiral=адмирал
adoptieren=усыновлять
Adoption=усыновление
Adresse=адрес
AdreЯtafel=адресная доска
Aerobik=аэробика
aerokosmisch=аэрокосмический
Aerosol=аэрозоль
Affe=обезьяна
Afghanistan=Афганистан
Afrika=Африка
Afrikaner=африканец
Agent=агент
Agentur=агентство
Aggression=агрессия
aha=ага
Ahle=шило
ahnen=предчувствовать
Ahorn=клен
Akademie=академия
Akazie=акация
Akkordeon=аккордеон
Akrobat=акробат
Akt=акт
Aktenschrank=ящик архивных папок
Aktentasche=портфель
aktiv=активный
aktivieren=активизировать
Alabama=Алабама
Alabaster=алебастр
Albatros=альбатрос
Album=альбом
Aleut=алеут
Alge=водоросль
Algebra=алгебра
Algerien=Алжир
Alibi=алиби
alkoholfreies Getrдnk=безалкогольный напиток
alkoholisch=алкогольный
alle=все
Allee=аллея
allegorisch=аллергический
alles=все
Allesfresser=всеядное существо
allgemein=общий
Alligator=аллигатор
allmдhlich=понемногу
allnдchtlich=еженощный
allseitig=всесторонний
Alpaka=альпака
alphabetisch=алфавитный
Alptraum=кошмар
als=чем
alt=старый
Alternative=альтернатива
altertьmlich=древний
altmodisch=старомодный
Altstoff=утиль
am Ende=в конце
am fernsten=самый дальний
am Leben bleiben=выжить
am Ufer=у берега
am Vorabend=накануне вечером
am wenigstens=меньше всего
Amboss=наковальня
Ameise=муравей
Ameisenbдr=муравьед
Ameisenhaufen=муравейник
Amerika=Америка
amerikanischer Elch=американский лось
Amethyst=аметист
Ammoniak=аммиак
amortisieren=амортизировать
Amphitheater=амфитеатр
Amsel=черный дрозд
amьsieren=веселить
an=на
an Bord=на борт
an der Oberflдche=на поверхности
Anakonda=анаконда
analysieren=анализировать
Ananas=ананас
Anarchie=анархия
anbetungswьrdig=обожаемый
Anblick=зрелище
anblicken=мельком взглянуть
andere=другой
anderer=иной
anders=иначе
Anemone=ветреница
Anerkennung=признание
Anfall=приступ
Anfang=начало
anfeuchten=замачивать
Anfrage=запрос
Anfдnger=начинающий
anfьllen mit Gas=наполнять газом
Angaben=данные
angeboren=прирожденный
Angeklagter=подсудимый
Angelhacken=рыболовный крючок
Angelrute=удилище
Angelschnur=леска
angespannt=интенсивный
Angestellter=клерк
angezьndet=зажженный
Angina=ларингит
Angleichung=уравнение
Angola=Ангола
Angst=страх
anhalten=останавливать
Anhдnger=прицеп
Anhдufung=скопление
Anhцren=прослушивание
Anker=якорь
Anklage=обвинение
anklagen=обвинять
ankommen=прибывать
Ankunft=прибытие
Anlegestelle=пристань
Anlegung=закладка
Anleihe=заем
anlernen=приучать
anmaЯend=самонадеянный
Anmeldung=запись
Annahme=принятие
annehmbar=приемлемый
annehmen=принимать
anonym=анонимный
Anorak=спортивная куртка
anordnen=располагать
Anordnung=расположение
anpassen=приспособлять
Anpassung=приспособление
Anrede=обращение
Anregung=возбуждение
Anrichte=сервант
Ansager=конферансье
anschaffen=приобретать
anschauen=созерцать
anschwellen=раздуваться
Ansehen=престиж
Ansicht=показ
anstecken=заражать
ansteckend=заразный
Ansteckung=заражение
Anstreicher=маляр
anstrengen=напрягать
anstrengend arbeiten=напряженно работать
Anstrich=окраска
Anstrichdose=банка для краски
anstдndig=приличный
Ansuchen=ходатайство
Antarktis=Антарктида
Anteil=порция
Antenne=антенна
Anthologie=антология
Antikцrper=антитело
Antilope=антилопа
Antisepsis=антисептик
Antitoxin=антитоксин
Antonym=антоним
Antragsteller=заявитель
Antrieb=побуждение
antworten=отвечать
anvertrauen=поручать
Anwalt=защитник
Anwendung=приспособление
anwesend sein=присутствовать
Anwesenheit=присутствие
Anzeige=объявление
anzeigen=уведомлять
Anzeiger=указатель
anziehen=одевать
Anziehung=притяжение
Anzug=костюм
Anzug (Kostьm)=костюм
Anдsthesie=обезболивание
Aorta=аорта
Apache=апач
Apartheid=апартеид
Apartmenthaus=многоквартирный дом
Apathie=апатия
Apfel=яблоко
ApfelsoЯe=яблочный соус
Apostroph=апостроф
Apotheke=аптека
Apotheker=аптекарь
Apparat=прибор, устройство
Appendizitis=аппендицит
Appetit=аппетит
appetitlich=аппетитный
applaudieren=аплодировать
Aprikose=абрикос
April=апрель
Aquarell=акварель
Aquarium=аквариум
Aquдdukt=акведук
Araber=араб
Arabien=Аравия
arabisch=арабский
Arbeit=труд
arbeiten=работать
arbeitend=работающий
Arbeiter=рабочий
Arbeitsanzug=комбинезон
Arbeitshandschuhe=рабочие рукавицы
arbeitslos=безработный
Arbeitslosigkeit=безработица
Arbeitstisch=рабочий стол
arbeitsunfдhig=нетрудоспособный
Arbeitszimmer=кабинет
Architekt=архитектор
Archivbeamter=архивариус
Archдologie=археология
argwцhnisch=недоверчивый
Aristokrat=аристократ
Aristokratin=аристократка
Arithmetik=арифметика
Arkade=аркада
arktisch=арктический
arm=бедный
Armada=армада
Armaturenbrett=приборная доска
Armband=браслет
Armbanduhr=наручные часы
Armbrust=самострел
Armlehne=подлокотник
armselig=скудный
Armut=бедность
Aroma=аромат
aromatisch=ароматный
Arsen=мышьяк
Arterie=артерия
Arthritis=артрит
Artikel=статья
Artillerie=артиллерия
Artilleriegeschoss=артиллерийский снаряд
Artischocke=артишок
Arzt=врач
As=туз
Asbest=асбест
Asche=пепел
Aschenbecher=пепельница
asiatisch=азиатский
Asien=Азия
Asphalt=асфальт
Aspirin=аспирин
Aster=астра
Asteroid=астероид
Astgabel=развилина
Asthma=астма
Astrologie=астрология
Astronaut=астронавт
Astronom=астроном
Astronomie=астрономия
astronomisch=астрономический
Asyl=приют
Atem=дыхание
Atheist=атеист
Athletik=атлетика
atlantisch=атлантический
Atlas=атлас
atmen=дышать
Atmosphдre=атмосфера
atmosphдrisch=атмосферный
Atmungs=дыхательный
Atoll=атолл
Atom=атом
atomar=атомный
attraktiv=привлекательный
Aubergine=баклажан
auch=также
auch nicht=также не
audio=аудио
Auditorium=аудитория
auf dem Heck=на корме
auf die Achse aufsetzen=насаживать на ось
auf diese Weise=таким образом
auf frischer Tat=с поличным
auf halbem Weg=на полпути
auf sich nehmen=брать на себя
auf solche Weise=таким образом
auf Wiedersehen=до свидания
Aufbau=строительство
Aufbewahrung=сохранение
Aufeinanderfolge=преемственность
Aufenthalt=местопребывание
Aufenthaltsort=местопребывания
auffangen=перехватить
Auffliegen=взлет
Auffьhrung=представление
Aufgabe=задание
aufgeregt=взволнованный
aufhalten=задерживать
aufheben=отменять
aufheitern=развеселить
aufhдngen=подвешивать
Aufhдnger=вешалка
aufhдufen=наваливать
aufhцren=прекращать
Aufkleber=наклейка
aufklдren=просвещать
auflцsen=решать
aufmachen=открывать
aufmerksam=внимательный
Aufmerksamkeit=внимание
aufpassen=обращать внимание
aufregen=тревожить
aufregend=волнующий
Aufregung=волнение
aufrichtig=откровенный
Aufruf=воззвание
aufrufen=вызывать
Aufruhr=бунт
aufrдumen=прибираться
Aufsatz=сочинение
aufschieben=отсрочивать
Aufschlag=отворот на брюках
aufschneiden=нарезать
Aufschub=приостановка
Aufseher=надзиратель
Aufstand=восстание
Aufstehen=вставание
aufstellen=расставлять
Aufstieg=восхождение
aufstoЯen=открыть ударом
auftauchen=появляться
Auftrag=поручение
aufwachen=пробуждать
Aufwand=роскошь
aufzehren=истощать
Augenblick=миг
augenblicklich=моментальный
Augenbraue=бровь
Augenlid=веко
Augenoptiker=окулист
Augenschatten=тени
Augenstift=карандаш для глаз
Augenzeuge=очевидец
August=август
Augдpfel=глазное яблоко
Auktion=аукцион
ausatmen=выдыхать
Ausbeute=добыча
ausbeuten=эксплуатировать
ausbilden=давать образование
Ausbildung=образование
ausbluten=пускать кровь
ausbrechen=извергаться
ausbreiten=раскладывать
ausbrьten=высиживать
ausdehnen=протянуть, протягивать
Ausdruck=листинг
Ausdruckskraft=выразительность
ausdrucksvoll=выразительный
auseinanderwerfen=раскидывать
Ausfahrt=знак "выезд"
Ausflucht=увертка
Ausflug=загородная прогулка
Ausflьge=поездки
Ausfuhr=экспорт
Ausgabe=издание
Ausgang=исход; конец
Ausgangsausfahrt=выезд на развязку
ausgeben=тратить
ausgedehnt=обширный
ausgestreckt=распростертый
ausgewдhlt=выбранный
ausgezeichnet=отличный
ausglьhen=прокалывать
aushцhlen=выдалбливать, выдолбить
Aushцhlung=выбоина
auskundschaften=разведывать
Auskunftsabteilung=справочный отдел
Auskunftstelle=стол для справок
Ausladen=разгрузка
Ausleger=стрела крана
ausleihen=давать взаймы
Auslдnder=иностранец
auslдndisch=иностранный
auslцschen=тушить
Ausnahme=исключение
auspfeifen=освистывать
auspressen=выжать
ausprobieren=испытывать
Auspuffrohr=выхлопная труба
ausrauben=грабить
ausrechnen=вычислить
Ausrede=предлог
AusreiЯer=беглец
ausrotten=искоренять
Ausruf=восклицание
ausrufen=восклицать
Ausrufewort=междометие
ausruhen=релаксация
ausrьsten=оборудовать
Ausrьstung=альпинистское снаряжение
Aussatz=награда
Ausschlag=сыпь
ausschlieЯen=исключать
ausschlieЯlich=исключительный
Aussicht=перспектива
Aussprache=произношение
aussprechen=произносить
Ausstattung=снаряжение
ausstellen=выставлять
Ausstellung=выставка
Ausstellungstisch=стол выписки
ausstoЯen=извергать
ausstrahlen=излучать
ausstrecken=протягивать
Ausstreichen=зачеркивание
aussuchen=выбирать, выбрать
Austausch=обмен
Auster=устрица
Australien=Австралия
Austrдger=разносчик
Austrдgerin=разносчица
Auswahl=ассортимент
Auswanderer=эмигрант
auswдrts=снаружи
Auszeichnung=награда
ausziehen=раздевать
Auszug=выдержка
Auto=автомобиль
Autobahn=автострада
Autobus=автобус
Automation=автоматизация
automatisch=автоматический
Autor=автор
Autorallye=авторалли
Autorenhonorar=авторский гонорар
auЯenbord=за борт
AuЯenseite=наружная сторона
auЯerdem=кроме того
auЯerhalb=за пределами
AuЯerirdischer=инопланетянин
Axt=топор
Azalee=азалия
Azteke=ацтек
Bach=ручей
backen=выпекать, печь
Backenbart=бакенбард
Backenzahn=коренной зуб
Backfisch=жареная рыба
Backpflaumen=чернослив
Badeanzug=купальник
Badehose=плавки
Badekappe=шапочка для душа
Bademantel=купальный халат
Badeteppich=коврик для ванны
Badetuch=полотенце для ванны
Badezimmer=ванная комната
Bagger=землечерпалка
Bahnhof=вокзал
Bahnsteig=перрон
Bajonett=штык
Bakterien=микробы
Balanсierstange=балансир
Baldachin=балдахин
Balken=балка
Balkenweg=бревенчатая дорога
Balkon=балкон
Ball=мяч
Ballade=баллада
Ballast=балласт
Ballerina=балерина
Ballett=балет
Bambus=бамбук
Banalitдt=банальность
Banane=банан
Band=том
Banjo=банджо
Bank=скамейка
Bankier=банкир
Bankrotteur=банкрот
Banner=знамя
Bar=бар
Barbar=варвар
barfьЯig=босой
Bargeld=наличные
bargeldlos=безденежный, безналичный
Bariton=баритон
Barmann=бармен
Barmherzigheit=милосердие
Barmherzigkeit=великодушие
Barometer=барометр
Baron=барон
Barrakuda=барракуда
Barren=слиток
Barriere=барьер
Bart=борода
Basar=базар
Baseball=бейсбол
Baskenmьtze=берет
Basketball=баскетбол
Bassgitarist=бас-гитарист
Bataillon=батальон
Batterie=батарея
Bau=строительный
Bauarbeiter=строительный рабочий
Bauch=живот
Bauchspeicheldrьse=поджелудочная железа
bauen=строить
Bauer=пешка
Bauernhaus=дом фермера
Bauholz=строевой лес
Baukunst=искусство
Baum=дерево
Baumstumpf=пень
Baumwolle=хлопок
Baumwollstoff=бумажная ткань
Bauplatz=стройплощадка
beanspruchen=претендовать, требовать
Beben=сотрясение
Becken=музыкальные тарелки
Bedauern=сожаление
bedecken=покрывать
bedeuten=обозначать
bedeutend=значительный
Bedeutung=значение
bedienen=прислуживать, обслуживать
bedingt=обусловленный
Bedingung=обстоятельство
Bedьrftige=нуждающийся
Beefsteak=бифштекс
beenden=заканчивать
beerdigen=хоронить
Beere=ягода
Befehl=приказ
befehlend=повелительный
befestigen=прикреплять
befeuchten=увлажнять
befreien=освобождать
Befreiung=освобождение
befriedigen=удовлетворять
befriedigend=удовлетворительный
Befriedigung=удовлетворение
befцrdern=отправлять
Befьrchtung=опасение
begabt=способный
begehren=жаждать
begeistert=восторженнный
Begeisterung=вдохновение
Begierde=сильное желание
beginnen=начинать
beglaubigen=заверять
begleiten=сопровождать
Begleitung=сопровождение
Begonie=бегония
begreifen=постигать
begrenzen=ограничивать
begrenzt=ограниченный
Begrдbnis=похороны
begrьЯen=приветствовать
BegrьЯung=приветствие
behalten=сохранять
beharren=упорствовать
behauen=тесать
behaupten=утверждать
Behauptung=подтверждение
behelfsmдЯig=вспомогательный
Beherrschung=освоение
Behдlter=резервуар
beide=оба
BeifuЯ=полынь
beige=бежевый
Beigeschmack=привкус
Beil=плотничий топор
Beilage=гарнир
Beinchen=ножка
beiseite=в сторону
Beistand=содействие
beistimmen=соглашаться
beitragen=делать вклад
beiЯen=кусать
bejahrt=пожилой
bekannt machen=знакомить
Bekanntheit=известность
Bekanntschaft=знакомство
bekommen=доставать
bekдmpfen=сражаться
bekьmmert=убитый горем
belagern=осаждать
belebte Natur=живая природа
belegtes Brot=бутерброд
beleibt=дородный
beleidigen=оскорблять
beleuchten=освещать
beliebig=любой
belдstigen=докучать
bemerkbar=заметный
bemerken=замечать
bemerkenswert=замечательный
Bemerkung=замечание
Benennung=наименование
benetzen=орошать
bengalisches Feuer=бенгальский огонь
benutzen=использовать
Benzin=бензин
Benzinanzeige=индикатор бензина
Benzinfass=бензобак
beobachten=наблюдать
Beobachtung=наблюдение
Beobachtungs=наблюдательный
Bequemlichkeit=удобство
berechnen=подсчитывать
Berechnung=вычисление
Bereich=участок
bereichern=обогащать
bereit=готовый
bereiten=готовить
Berg=гора
Bergbau=горное дело
Berghammel=горный баран
Berghang=склон холма
bergig=гористый
Bergkette=горная цепь
Bergland=гористая часть
Bernstein=янтарь
Beruf=специальность
beruhigen=успокаивать
berдuchern=окуривать
berьchtigt=пресловутый
berьhmt=популярный
berьhmt machen=прославлять
berьhren=прикасаться
Besatzung=гарнизон
beschauen=обозревать
bescheiden=скромный
bescheidenes Schicksal=скромная доля
Bescheinigung=сертификат
beschenken=одарять
beschlagnahmen=конфисковать
beschlieЯen=решать, постановлять
Beschluss=решение, постановление
beschneiden=подрезать
beschreiben=описывать
beschreibend=описательный
Beschreibung=описание
beschrдnken=ограничивать
Beschrдnkung=ограничение, лимит
beschuldigen=обвинять
Beschwцrung=заклинание
beschдdigen=портить
beschдftigt=занятый
Beschдftigung=занятость
beschдmt=пристыженный
beschьtzen=защищать
Beschьtzer=покровитель
besetzen=занимать, оккупировать
besingen=воспевать
Besitz=владение
besitzen=обладать
Besitzer=хозяин
Besitzer der Saisonkarte=владелец сезонки
Besitzung=имение
Besonderheit=особенность
besonders=особенно
besprechen=обсуждать
Besprechung=обсуждение
besprengen=окроплять, обрызгивать
bespritzt=забрызганный
besser=лучше
Besserung=исправительный
Besserungsanstalt=исправительный дом
Bestandteil=составная часть
Bestechung=взятка
bestehen=настаивать
bestellen=заказывать
Besteuerung=налогообложение
bestimmen=назначать
bestimmt=определенный
Bestimmung=определение
bestrafen=наказывать
bestreichen=намазывать
bestдndig=постоянный
Bestдndigkeit=стабильность
bestдtigen=утверждать
Bestдtigung=утверждение
bestдuben=посыпать
Bestдubung=опыление
Besuch=визит
Besucher=посетитель
beten=молиться
Beton=бетон
Betonmischmaschine=бетономешалка
Betonung=ударение
betrachten=рассматривать
Betrachtung=рассмотрение
Betrug=обман
betrunken=пьяный
betrьben=огорчать
betrьgen=обманывать
Betrьger=обманщик
Bett=кровать
Bettler=нищий
Bettruhe=постельный режим
Bettwдsche=постельное белье
betдuben=оглушать
Betдubung=обезболивание, наркоз
Beule=шишка
beunruhigen=беспокоить
beurteilen=характеризовать
Beutelratte=сумчатая крыса
Beuteltier=сумчатый
bevollmдchtigen=санкционировать
Bevollmдchtigte=уполномоченный
bevor=прежде
bevor nicht=пока не
Bevorzugung=предпочтение
Bevцlkerung=население
bewahren=хранить
bewegen=двигать
beweglich=подвижный
Bewegung=движение
bewegungslos=неподвижный, статичный
beweinen=оплакивать
Beweis=аргумент
beweisen=доказывать
bewerten=оценивать
bewohnen=обитать
Bewohner=жилец
bewohnt=населенный, жилой
bewundern=восхищаться
Bewunderung=восхищение
bewusst=сознательный
Bewдsserung=орошение
bewцlkt=облачный
bezahlbar=оплачиваемый
Bezahlung=платеж
bezaubern=очаровывать
bezaubernd=обаятельный
bezeichnen=предназначать
beziehen=обивать
Bezugstoff=обивка
Bibel=Библия
Biber=бобр
Bibliothek=библиотека
Bibliothekarin=библиотекарь
Bibliotheksbus=библиотечный автобус
biblisch=библейский
biegen=изгибать
biegsam=гибкий
Biene=пчела
Bier=пиво
Bierglas=стакан для пива
Bikini=трусики бикини
Bilanz=баланс
Bild=живопись
bilden=составлять
Bildhauer=скульптор
Bildungs=образовательный
Billard=бильярд
Billett=билет
billig=дешевый
Binde=бинт
Bingo=бинго
Biologe=биолог
Biologie=биология
Birke=береза
Birma=Бирма
Birne=груша
bis=до
Bisamratte=ондатра
Bischof=епископ
Biskuit=бисквит
Bison=бизон
Bissen=кусок
bisweilen stechen=временами прокалывать
bitte=пожалуйста
bitten=просить
bitter=горький
Bizeps=бицепс
Blase=волдырь
blasen=дуть
Blasinstrument=духовой инструмент
Blatt=лист
blau=голубой
blaue Flecke=синяки
blauer Fleck=синяк
blaugrau=синевато-серый
blaЯ=бледный
bleiben=оставаться
Bleichpulver=отбеливатель
Bleistift=карандаш
Bleistiftanspitzer=точилка
blendend=ослепительный
Blick=взгляд
Blickfeld=поле зрения
blind=слепой
Blindenschrift=шрифт Брайля
blinken=сверкать
Blinken=мерцание
Blinker=сигнал поворота
blinzeln=моргать
Blitz=вспышка
Block=глыба
Blockade=блокада
Blockbau=блочное строительство
Blockflцte=дудка
Blonde=блондин
Blues=блюз
Blume=цветок
Blumenblatt=лепесток
Blumengewinde=гирлянда цветов
Blumenkohl=капуста цветная
Bluse=блузка
Blut=кровь
blutarm=малокровный
Blutbad=резня
blutdьrstig=кровожадный
blutend=кровоточащий
Blutkreislauf=кровообращение
Blutspender=донор
Blutung=кровоток
BlutvergieЯen=кровопролитие
Blдschen=пузырек
blцken=блеять
blьhen=цвести
blьhend=пышущий здоровьем
Blьte=цветение
Blьten=цветочный
Blьtenstaub=цветочная пыльца
Boa=удав обыкновенный
Bobolink=тупиал рисовый
Bobschlitten=бобслей
Bockleder=оленья кожа
Bockspringen=чехарда
Boden=почва
Bogen=лук
BogenschieЯen=стрельба из лука
Bohnen=фасоль
Bohnenkraut=чабрец
bohren=сверлить
Bohrer=дрель
Bohrturm=буровая вышка
Boiler=газовая колонка
Boje=буй
Bolivien=Боливия
Bollwerk=оплот
Bolzen=болт
Bombe=бомба
Bomber=бомбардировщик
Bonbon=конфета
Bongotrommel=бонго
Boot=лодка
Bordingenieur=бортинженер
Bordkante=бордюр
Bordkarte=посадочный талон
boshaft=зловредный
Bosheit=злость
Botaniker=ботаник
Bote=посыльный
Botschafter=посол
Bowling=боулинг
Box=коробка
Boxershorts=боксерские трусы
Boykott=бойкот
Brandschutzdraht=пожарный провод
Brandstiftung=поджог
Brandy=бренди
braten=жарить
Braten=жаркое
Bratrost=гриль
brauchbar=годный к употреблению
Brauchbarkeit=пригодность
brauchen=нуждаться
braun=коричневый
Brauntang=бурая водоросль
Braut=невеста
Brecheisen=лом
brechen=ломать
Brei=каша, паста
breit=широкий
Breite=ширина
Bremse=слепень
Bremslicht=стоп-сигнал
brennen=гореть
Brenner=горелка
Brennholz=дрова
Brennstoff=топливо
Bresche=брешь
Brett=доска
Bretterbelag=дощатый настил
Brezel=кренделек с солью
Brief=письмо
Briefeinwurf=щель в почтовом ящике
Briefkasten=почтовый ящик
Briefklammer=скрепка
Brieftasche=бумажник
Brieftrдger=почтальон
Brieftrдgertasche=сумка почтальона
Briefumschlag=конверт
Brigade=бригада
Brigg=бриг
Brikett=брикет
bringen=приносить
Britannien=Британия
britisch=британский
Brokat=парча
Brombeere=ежевика
bronchial=бронхиальный
Bronchitis=бронхит
Brontosaurus=бронтозавр
Bronze=бронза
Brosche=брошь
Brot=хлеб
Brotbox=ящик для ленча
Brotplatte=бутербродница
brr=тпру
Bruch=перелом
Bruder=брат
Bruderschaft=братство
brummen=брюзжать
Brummen=ворчание
Brust=бюст
Brustkasten=грудная клетка
Brustknochen=грудная кость
Bruststьck=грудка
Brut=выводок
Brдutigam=жених
Buch=книга
Buche=бук
Buchfink=зяблик
Buchhalter=бухгалтер
Bucht=залив
Buckel=горб
Budda=Будда
Buddhismus=буддизм
Budget=смета
Bulgarien=Болгария
Bullauge=иллюминатор
Bulldogge=бульдог
Bulldozer=бульдозер
Bulle=бык
Bulletin=бюллетень
Bumerang=бумеранг
bummeln=бродить
Bummler=прогульщик
Bungalow=бунгало
Buntestuch=пестрый платок
Bursche=парень
Busch=куст
buschig=кустистый
Bushaltestelle=автобусная остановка
Butter=масло
Butterblume=лютик
Butterfass=маслобойка
Butterfett=молочный жир
Bдcker=пекарь
Bдckerei=пекарня
Bдr=медведь
Bдrenhцhle=берлога
bцse=сердитый
Bцse=зло
bцse Vorahnung=дурное предчувствие
bцser Schдrz=грубая шутка
Bьcherkunde=библиография
Bьcherladen=книжный магазин
Bьcherschrank=книжный шкаф
Bьchse=банка
Bьffel=буйвол
Bьgel=вешалка
Bьgelbrett=гладильная доска
Bьgeleisen=утюг
bьgeln=гладить
Bьhne=сцена
Bьndel=пучок
bьndeln=собирать в пучки
Bьrger=столичный житель
Bьrgermeister=мэр
Bьrgerrecht=гражданское право
Bьrgersteig=тротуар
Bьro=бюро
Bьrste=щетка
Bьschel=пучок
Bьstenhalter=бюстгальтер
Cafe=кафе
Cafeteria=кафетерий
Camper=кемпер
Campingherd=туристская плита
Cantaloupe=канталупа
Caschewnuss=орех кешью
Celcius=Цельсий
Cello=виолончель
Cent=цент
Chamдleon=хамелеон
Chance=шанс
Chansen=шансы
Charakter=характер
Charakterzug=черта характера
Charme=обаяние
Charta=хартия
Chef=босс, начальник
Chemie=химия
Chemiker=химик
chemisch=химический
Chemotherapie=химиотерапия
Cherokese=черокез
Chile=Чили
Chilepfeffer=чилийский перец
Chinchilla=шиншилла
chinesisch=китайский
Chips=хрустящий картофель
Chirurg=хирург
Chirurgie=хирургия
Chlorophyll=хлорофилл
Chor=хор
Christ=христианин
Christus=Христос
Chrom=хром
chronisch=хронический
Chrysantheme=хризантема
Cidre=сидр
Clan=клан
Clown=клоун
Cockpit=кабина водителя
Collie=колли
Colt=кольт
Combine=комбайн
Comicstrip=юмористические картинки
Computer=компьютер
Computerkenntnis=компьютерная грамотность
Computerplan=компьютерная графика
Connecticut=Коннектикут
Container=контейнер
Containerwagen=контейнер
Copilot=второй пилот
Couch=кушетка
Cowboy=ковбой
Creme=крем
D=дэ
Dach=крыша
Dachfirst=конек крыши
Dachs=барсук
Dachstuhl=стропильная ферма
Dame=дама, леди
Damenschlьpfer=колготки
Damenslip=женские трусы
Damespiel=игра в шашки
Damm=плотина
Dampf=пар
Dampfer=пароход
Dampfschiff=пароход
Dampfwerk=паровой механизм
danach=после этого
dankbar=благодарный
Dankbarkeit=благодарность
danke=спасибо
danken=благодарить
Danksagung=благодарение
dann=затем
Darm=кишка
darstellen=представлять
Darsteller=исполнитель
darunterschieben=подпихивать
das Bett machen=прибирать постель
das Eingesalzene=соленья
dasselbe=тот же самый
Datenbasis=база данных
Dattel=финик
Dattelpflaume=хурма
dauerhaft=долговременный
Daumen=кулачок
Daunen=пух
dazwischenliegend=промежуточный
Debatte=дебаты
Deck=крыльцо
Decke=покров
Deckel=покрышка
decken=укрывать
Defekt=дефект
dein=твой
Dekoration=декорация
Dekorierung=украшение
Dekret=декрет
Delegation=делегация
Delegierte=делегат
Delikatesse=деликатесы
Delphin=дельфин
Delta=дельта
Demokrat=демократ
Demokratie=демократия
demokratisch=демократический
Demonstration=демонстрация
den SchluЯ ziehen=делать вывод
denken=думать
denkend=мыслящий
Denkmal=памятник
Denkschrift=памятная записка
Dentist=дантист
Deponent=вкладчик
Depot=депо
der achte=восьмой
der achtzehnte=восемнадцатый
der beste=лучший
der dreizehnte=тринадцатый
der elfte=одиннадцатый
der erste=первый
der fьnfte=пятый
der fьnfzehnte=пятнадцатый
der grцЯte=наибольший
der hundertste=сотый
der kleine Finger=мизинец
der neunzehnte=девятнадцатый
der neunzigste=девяностый
der sechste=шестой
der sechzehnte=шестнадцатый
der sechzigste=шестидесятый
der siebte=седьмой
der siebzehnte=семнадцатый
der siebzigste=семидесятый
der tausendste=тысячный
der vierzehnte=четырнадцатый
der zwanzigste=двадцатый
der zwцlfte=двенадцатый
deshalb=в связи с этим
Designer=модельер, дизайнер
Dessert=десерт
Detektor=детектор
deutlich=отчетливый
deutlich sprechen=произносить отчетливо
deutsch=по-немецки
Dezember=декабрь
dezimal=десятичный
Diabetes=диабет
Diagnose=диагноз
Diagonale=диагональ
Diagramm=диаграмма
Diakon=дьякон
Dialog=диалог
Diamant=алмаз
Diaphragma=диафрагма
Diapositiv=слайд, диапозитив
Diaprojektor=диапроектор
dicht=плотный
Dicht=плотность
dicht bevцlkert=густонаселенный
Dichter=поэт
dick=толстый
Dicke=толщина
dicker machen=утолщать
Dickicht=чаща
die Philippinen=Филиппины
Dieb=вор
Diebstahl=грабеж
Dienst=служба
Dienstag=вторник
Dienstmдdchen=служанка
diese=эта
Diesel=дизель
dieses=это
Diktator=диктатор
diktieren=диктовать
Dilettant=дилетант
Ding=предмет
Dinner=слуга
Dinosaurier=динозавр
Diplomat=дипломат
diplomatisch=дипломатический
dir; dich=тебя
direkt=прямой
Direktor=директор
Dirigent=дирижер
Diskette=дискета
Diskjockey=диск-жокей
diskriminieren=дискриминировать
Diskriminierung=дискриминация
Diskus=диск
disponieren=располагать
disqualifizieren=дисквалифицировать
Distel=чертополох
Disziplin=дисциплина
Dividende=дивиденд
Division=деление
Divisor=делитель
Diдt=диета
Diдtarzt=диетврач
doch=все же
Docht=фитиль
Dogge=дог
Doktrin=доктрина
Dokument=документ
Dolch=кинжал
Dollar=доллар
Dolle=уключина
dominieren=доминировать
Domino=домино
Donner=гром
Donnerstag=четверг
Doping=допинг
Doppeldecker=биплан
Doppelgдnger=двойник
Doppelkinn=второй подбородок
doppelt=двойной
Dorf=деревня
Dorfbewohner=сельский житель
Dorn=шип
Dorsch=треска
dort=там
Drache=дракон
Drachen=бумажный змей
Draht=проволока
drahtlos=беспроволочный
Drahtpuppe=марионетка
Drahtseil=стальной канат
Drahtseilbahn=фуникулер
Dramatiker=драматург
dramatisch=драматический
dramatisieren=драматизировать
Drapierung=драпировка
drauЯen=на открытом воздухе
Drehapparate=вращающийся аппарат
Drehbank=токарный станок
drehen=скручивать
drehend=вращательный
Drehgestell=вращающийся штатив
Drehkreuz=турникет
Drehtьr=вертушка
Drehung=вращение
drei=три
Drei=тройка
Dreieck=треугольник
dreieckig=треугольный
dreifach=тройной
Dreirad=трехколесный велосипед
dreizehn=тринадцать
dreiЯig=тридцать
dreschen=молотить
Dreschmaschine=молотилка
driften=дрейфовать
drinnen=внутри
Drittel=третья часть
drohen=угрожать
Drohne=трутень
Drohung=угроза
Dromedar=одногорбый верблюд
Drossel=дрозд
Druck=натиск
drucken=печатать
Drucker=печатающий механизм
Druckknopf=кнопка
drunter und drьber=кувырком
Drдnage=дренаж
drьcken=нажать
Drьse=железа
Dschungel=джунгли
du=ты
Dudelsack=волынка
Duett=дуэт
Duft=запах
dumm=глупый, тупой
Dummkopf=неумный человек
dunkel=темный
Dunkelheit=мрак
Dunst=дымка
durch=через
durch gedrehtes Rindfleisch=говяжий фарш
durchbrechen=прорезываться
Durchbruch=прорыв
durchdringen=проникать
Durcheinander=беспорядок, неразбериха
Durchfall=понос
durchfьhrbar=осуществимый
Durchgang=транзит
durchhalten=выстоять
durchkreuzen=пересекать
Durchmesser=диаметр
durchnдssen=промачивать
durchreiben=протирать
durchschieben=продвигать вперед
DurchschuЯ=пробоина
durchsehen=просматривать
Durchsicht=проверка
durchsichtig=прозрачный
durchsickern=просачиваться
durchsieben=просеивать
durchtrдnken=пропитывать
Durchzдhlen=пересчитывание
Durst=жажда
durstig=жаждущий
Dutzend=дюжина
dynamisch=динамический
Dдmon=демон
dдmpfen=парить
Dдnemark=Дания
dдnisch=датский
Dьne=дюна
Dьngung=удобрение
dьnn=тонкий
dьrr=изможденный
Dьrre=засуха
Dьsenmotor=реактивный двигатель
E=э
Ebenholz=черное дерево
Eber=кабан
ebnen=выравнивать
Echo=эхо
echt=сущий
Echtheit=подлинность
Ecke=угол
Eckstein=угловой блок
Ecktisch=угловой столик
edel=благородный
Edelmut=благородство
Edelstein=драгоценный камень
Efeu=плющ
effektiv=эффективный
Egel=пиявка
Egge=борона
egoistisch=эгоистичный
Ehering=кольцо для помолвки
Ehre=честь
Ehrenzeichen=знаки отличия
Ehrfurcht=почтение
Ehrgeiz=честолюбие
ehrlich=честный
Ehrlichkeit=честность
ehrsьchtig=честолюбивый
Ei=яйцо
Eibe=тисовое дерево
Eiche=дуб
Eichel=желудь
Eichelhдher=сойка
Eichhцrnchen=белка
Eidechse=ящерица
Eierkuchen=омлет
eifersьchtig=ревнивый
eigenen=быть пригодным
Eigenschaft=свойство
eigensinnig=упрямый
Eigentum=собственность
eigenwillig=своевольный
Eile=спешка
eilen=торопиться
eilig=поспешный
Eilpost=срочная почта
Eimer=ведро
ein=один
ein dreiteiliger Anzug=костюм-тройка
ein jeder=каждый
ein volles Jahr=круглый год
ein von beiden=один из двух
ein wenig=немного
ein wenig geцffnet=приоткрытый
einarmig=однорукий
einatmen=вдыхать
einberufen=призывать в армию
Einberufene=призывник
Einberufener=новобранец
Einbildungskraft=сила воображения
Einbrecher=взломщик
Einbruch=вторжение
eindringen=вторгаться
Eindruck=лед, вмятина
eindrucksvoll=впечатляющий
eine Portion=одна порция
einfach=просто
Einfachheit=простота
Einfahrt=въезд
Einfall=выдумка, идея
einflussreich=влиятельный
einflцЯen=внушать
einfrieren=замораживать
einfьhrend=вводный
Einfьhrung=введение
Eingang=вход
eingebaut=построенный
eingefallen=впалый
eingesetzte Nummer=вставной номер
Eingeweide=потроха
Einheit=единство
Einhorn=единорог
einige=несколько
Einkaufstasche=сумка для покупок
Einkesselung=осада
Einkommen=доход
einkreisen=окружать
einladen=приглашать
Einladung=приглашение
Einlage=вложение
einleiten=запускать
einmal=однажды
Einmischung=вмешательство
einmьtig=единодушный
einpacken=обертывать
einpflanzen=насаждать
Einrad=одноколесный велосипед
einreiben=растирать
Einrichtung=устройство
Eins=единица
einsam=одинокий
Einsamkeit=уединение
einschlagen=вбивать в землю
einschlieЯen=включать
Einschluss=включение
einschmieren=смазывать
einschmuggeln=провоз контрабандой
Einschnitt=надрез
einschreiben=вписывать
einschьchtern=запугивать
einsehen=сознавать
einseitig=односторонний
einsetzen=вставлять
Einsiedler=отшельник
Einspritzung=впрыскивание
einstellen=приостанавливать
einstellige Zahl=однозначное число
einstimmig=единогласный
Einsturz=обвал
eintauchen=погружаться в воду
Eintragung=запись
eintreten=входить
einverstanden sein=соглашаться
Einverstдndnis=согласие
Einwand=возражение
Einwanderer=иммигрант
einwandern=иммигрировать
Einwilligung=согласие
einwirken=влиять
Einwurf=вбрасывание(спор.)
einzeln=отдельный
Einzelverkauf=розничная продажа
Einzug=въезд
einдschern=испепелять
Eis=лед
Eisbahn=каток
Eisberg=айсберг
Eisbrecher=ледокол
Eisbдr=белый медведь
Eisenbahn=железная дорога
Eisenwaren=скобяные изделия
Eishockeystock=клюшка
eisig=ледяной
Eispaket=пакет со льдом
Eisscholle=льдина
Eisschrank=морозильная камера
Eisvogel=зимородок
Eiszapfen=сосулька
Eiter=гной
EiweiЯ=белок
elastisch=упругий
elastische Binde=эластичный бинт
Elch=лось
Elefant=слон
elegant=элегантный
elektrisch=электрический
Elektrizitдt=электричество
Elektrobohrer=электродрель
Elektromagnet=электромагнит
Elektromonteur=электромонтер
Elektron=электрон
Elektronen=электронный
Elektronik=электроника
Elektrosдge=электропила
Element=элемент
Elendsbehausungen=трущобы
elf=одиннадцать
Elf=эльф
Elfen=эльфы
Elfenbein=слоновая кость
Ellbogen=локоть
Ellipse=эллипс
Elster=сорока
Eltern=родители
Email=эмаль
Embargo=эмбарго
Emblem=эмблема
emigrieren=эмигрировать
Empfang=прием
empfangen=принимать
empfehlen=рекомендовать
empfehlend=рекомендуемый
Empfehlung=рекомендация
empfindlich=чувствительный
Empfдnger=приемник
empor=вверх
emporwerfen=подбрасывать
empцrend=возмутительный
EmustrauЯ=эму
End=конечный
Ende=конец
endgьltig=окончательный
energetisch=энергетический
energisch=энергичный
eng=узкий
englischer Soldat=английский солдат
Englдnderin=англичанка
Engpass=ущелье
Enkel=внук
Enkelin=внучка
enorm=громадный
Entbindung=родоразрешение
entdecken=обнаруживать
Entdeckung=открытие
Entdeckungen machen=делать открытия
Ente=утка
Entenkьken=утенок
Enterich=селезень
entfernt=отдаленный
entflammbar=воспламеняющийся
entgegenwirken=противодействовать
entgehen=избегать
enthalten=заключать в себе
enthaupten=обезглавливать
entkeimen=стерилизовать
entlang=вдоль по
entlarven=разоблачать
entlassen=распускать
entlehnen=заимствовать
entmutigen=обескураживать
entrдtseln=разгадывать
Entrьstung=негодование
entsagen=отказываться
entscheiden=решать
Entscheidung=решение
entschlossein=решительный
entschlьpfen=ускользать
entschlьsseln=расшифровывать
Entschuldigung=извинение
entschдdigen=возмещать
Entschдdigung=компенсация
entsetzlich=ужасающий
entseuchen=дезинфицировать
entsprechen=соответствовать
Entsprechen=соответствие
entsprechend=соответственный
entstellen=искажать
enttдuschen=разочаровывать
Enttдuschung=разочарование
entwickeln=развивать
Entwicklung=развитие
entwurzeln=вырывать с корнем
entziehen=лишать
entzweischneiden=делить пополам
Entzьcken=восторг
entzьndbar=воспламеняющийся
Entzьndung=воспламенение
Enzyklopдdie=энциклопедия
Epidemie=эпидемия
Epilepsie=эпилепсия
Episode=эпизод
Equador=эквадор
er=он
Erbauer=строитель
Erbe=наследник
erben=наследовать
erblich=наследственный
Erblichkeit=наследственность
erblicken=видеть
Erbsen=горох
Erdbeben=землетрясение
Erdbeere=земляника
Erdbeern=клубника
Erdbeerpirogge=клубничный пирог
Erde=земля
Erdeichhцrnchen=бурундук
erden=заземлять
Erdnuss=арахис
Erdцl=нефть
Ereignis=событие
erfahren=умудренный опытом
Erfahrung=опыт
Erfahrungen=сведения
erfinden=изобретать
Erfinder=изобретатель
Erfindergeist=изобретательность
erfinderisch=изобретательный
Erfindung=вымысел
Erfolg=успех
erfolgreich=успешный
erforschen=исследовать
Erforschung=исследование
erfrischen=освежать
Erfrischung=освежение
erfundener Name=вымышленное имя
erfьllen=выполнять
Erfьllung=выполнение
Ergebnis=результат
ergreifen=схватывать
Ergreifung=захват
ergдnzend=добавочный
Ergдnzung=дополнение
Ergдnzungs=дополнительный
erhaben=выпуклый
Erhabenheit=величие
erheben=поднимать
Erholung=отдых
Erholungszimmer=комната отдыха
erhцhen=повышать
erhцhter Blutdruck=высокое давление
erhцhter Stuhl=высокий стул
erinnern=напоминать
Erinnerung=воспоминание
Erinnerungsstьck=сувенир
erkalten=охлаждаться
erkennen=узнавать
Erkennung=узнавание
erklдren=объяснять
Erklдrung=заявление
Erklдrungsbrett=доска объявлений
erkranken=заболеть
erlauben=позволять
Erlaubnis=разрешение
Erle=ольха
erleben=пережить
erleichtern=облегчать
Erleichterung=облегчение
erloschen=потухнуть
erlцsen=избавлять
Ermordung=убийство
Ermutigung=подбадривание
ermдchtigen=уполномочивать
ermьdender Spaziergang=утомительная прогулка
ermьdet=уставший
erneuern=возобновлять
erniedrigen=унижать
ernst=серьезный
Ernte=урожай
Erntemaschine=уборочная машина
ernten=пожинать плоды
ernдhren=питать
ernдhrt=накормленный
Ernдhrung=питание
Eroberer=завоеватель
erobern=завоевывать
Eroberung=завоевание
Erosion=эрозия
Erpressung=шантаж
erregen=возбуждать
errichten=воздвигать
Ersatz=возмещение
Ersatzreifen=запасная шина
erschaffen=создавать
erscheinen=появляться
Erscheinen=появление
Erscheinung=видение
erschrecken=ужасать
erschrocken=испуганный
erschцpfen=истощать
erschцpfend=изнурительный
Erschцpfung=истощение
erschьttern=потрясать
ersetzbar=взаимозаменяемый
ersetzen=заменять
Ersparnisse=сбережения
erstaunen=изумлять
Erstaunen=изумление
erstaunlich=пораженный
ersticken=задыхаться
erstklassig=первоклассный
erstrangig=первостепенный
ertragen=выносить
ertrinken=тонуть
erwachen=проснувшийся
erwachsen=в возрасте
Erwachsene=взрослый
erwarten=ожидать
Erwartung=ожидание
erweichen=размягчаться
Erweiterung=расширение
Erwiderung=реплика
Erwдhnung=упоминание
erwьnscht=желательный
erwьrgen=удушать
Erz=руда
Erzbischof=архиепископ
erzeugen=порождать
Erzeugnis=изделие
Erzeugung=выпуск
erziehen=воспитывать
erzielen=достигнуть цели
erzittern=содрогаться
erzдhlen=рассказать
Erzдhlung=повествование
Esche=ясень
Esel=осел
Eskarole=сорт салата
Espe=осина
Essay=эссе
essbare Weichtiere=съедобные моллюски
essen=есть
Essig=уксус
Esslцffel=столовая ложка
Essstдbchen=палочки для еды
ethnisch=этнический
Etikett=ярлык
Etikette=этикетка
etwas=что-нибудь
Eukalyptus=эвкалипт
Eule=сова
europдisch=европейский
evakuieren=эвакуировать
Evangeliar=евангелие
Evolution=эволюция
ewig=навсегда, вечный
ewig grьn=вечнозеленый
Ewigkeit=вечность
Existenz=существование
Existenzmittel=средства к существованию
existieren=существовать
exotisch=экзотический
Expedition=экспедиция
Experiment=эксперимент
explodieren=взрываться
Explosion=взрыв
explosiv=взрывчатый
Exponierung=экспонирование
Export-Import=экспорт-импорт
Exposition=экспозиция
Expresszug=поезд-экспресс
extrahieren=извлечение
exzentrisch=эксцентричный
F=эф
Fabel=басня
Fabrikmarke=фабричная марка
Fachliteratur=научная литература
Fachmann=специалист
Fackel=факел
Faden=нить
Fagott=фагот
Fahne=флаг
fahren=кататься
Fahrer=водитель
Fahrersitz=сиденье водителя
Fahrgestell=посадочное шасси
Fahrkartenschalter=билетная касса
Fahrplan=расписание
Fahrpreis=стоимость проезда
Fahrrad=велосипед
Fahrradstьtze=велосипедная стойка
Fahrstuhl=лифт
Fahrt=поездка
Fahrwasser=фарватер
Fahrweg=проезд
Fahrwert=стоимость проезда
Fahrzeug=повозка
Faktor=фактор
Fakultдt=факультет
Falke=сокол
Fall=случай
fallen=падать
Fallreep=забортный трап
Fallschirm=парашют
Fallschirmsport=парашютный спорт
Fallschirmspringer=парашютист
Falltreppe=трап
falsch=ложный
falsch aussagen=лжесвидетельствовать
falsch aussprechen=неправильно произносить
falsche Anwendung=неправильное употребление
Falschheit=фальш
Falschmьnzer=фальшивомонетчик
Falschzahlung=неправильный подсчет
Falte=складка
falten=складывать
Familie=семья
Familienname=фамилия
Fanatiker=фанатик
fangen=поймать
Fangschlinge=аркан
Farbe=цвет
farbig=красочный
farbige Kreide=цветной мелок
Farbstoff=красящее вещество
Farm=ферма
Farmer=фермер
Farn=папоротник
Fasan=фазан
fassen=вмещать
Fassungsvermцgen=емкость
fast=почти
fatal=фатальный
Fatalfall=роковой случай
faul=ленивый
faulen=протухать
Fausthandschuh=рукавица
Februar=февраль
Feder=перо, птичье перо
Federball=бадминтон
Federbesen=перьевой веник
Fee=фея
Fehde=междоусобица
Fehler=ошибка
Fehler machen=делать ошибки
fehlerfrei=безошибочный
fehlerhaft=ошибочный
Fehlgewicht=недовес
FehlschuЯ=промах
Feierabend=конец рабочего дня
feierlich=торжественный
Feierlichkeit=празднество
feiern=праздновать
Feiern=празднование
feige=трусливый
Feige=инжир
Feigling=трус
Feile=напильник
fein=изящный
Feinde=враг
feindlich=враждебный
Feindlichkeit=враждебность
Feinschmecker=гурман
Feld=поле
Feldblume=полевой цветок
Feldstecher=полевой бинокль
Feldwebel=сержант
Felsen=скала
felsig=скалистый
Fensterladen=ставень
Fensterrahmen=оконная рама
Fensterscheibe=оконное стекло
Ferien=каникулы
Ferment=фермент
fernbetдtigt=дистанционный
Fernlenkung=пульт
Fernrohr=подзорная труба
Fernseher=телевизор
Fernsehprogramm=Т.В.передача
Ferse=пятка
fertig werden=управляться
Fertigkeit=навык
fesseln=связывать
fest=тугой
Fest=праздник
fest schlafen=крепко спать
festhalten=удерживать
Festigung=укрепление
Festmahl=банкет
feststellen=устанавливать
Festung=крепость
fett=жирный
Fett=жир
fett werden=жиреть
fettleibig=толстый
feucht=влажный
feucht werden=отсыреть
feuchter Kьhlverband=примочка
Feudalismus=феодализм
Feuer=огонь
feuerfest=огнеупорный
Feuerlцscher=огнетушитель
Feuermelder=пожарный датчик
Feuerspritze=брандспойт
Feuerstein=кремень
Feuerwehr=пожарный команда
Feuerwehrarbeit=пожарное депо
Feuerwehrmann=пожарник
Feuerwerk=фейерверк
Feuerzeug=зажигалка
feurig=огненный
Fichte=ель
Fieber=лихорадка
Fiesta=фиеста
Filet=филе
Filiale=филиал
Film=фильм
Filmapparat=киноаппарат
Filmrolle=катушка кинопленки
Filter=фильтр
Filterpapier=фильтровальная бумага
Finalist=финалист
finanziell=финансовый
finanzieren=финансировать
finden=находить
Finger=палец
Fingerabdruck=отпечаток пальца
Fingernagel=ноготь
Finne=финн
finnisch=финский
finster=хмурый
Finsternis=затмение
Fisch=рыба
Fischer=рыболов
Fischerboot=рыболовецкое судно
Fischerei=рыболовство
Fischnetz=сачок
Fjord=фиорд
flach=плоский
Flachs=лен
Fladen=оладья
Flagge=фланг
Flaggstock=флагшток
Flamingo=фламинго
Flamme=пламя
Flanell=фланель
Flanellhemd=фланелевая рубашка
Flanneljacke=фланелевая куртка
Flasche=бутылка
Flaschenzug=полиспаст
flattern=порхать
Flaum=пух
flaumig=пушистый
Flechte=лишайник
flechten=заплетать
Flechten=плетение
Flechtwerk=плетень
Fleck=пятно
Fleckchen=пятнышко
fleckenlos=незапятнанный
flehen=умолять
Fleisch=мясо
Fleischbullion=мясной бульон
Fleischer=мясник
fleischfressend=плотоядный
fleischfressendes Tier=плотоядное животное
fleischig=мясистый
fleischlos=без мяса; вегетарианский
Fleischpfannkuchen=блин с мясом
fleiЯig=трудолюбивый
Flicken=заплата
Flickenwerk=лоскутное изделие
Flieder=сирень
Fliege=муха
Fliegenfalle=мухоловка
Flieger=авиатор
Fliese=кафель
FlieЯband=конвейер
flirten=флиртовать
Flocken=хлопья
flog=летал
Floh=блоха
Florist=торговец цветами
Flosse=плавник
FloЯ=плот
Fluch=проклятие
Flucht=бегство
Flughafen=аэропорт
Flughalengebдude=здиние вокзала
Fluglinie=авиалиния
Flugplatz=аэродром
Flugwesen=авиация
Flugzeug=самолет
Flugzeughalle=ангар
Flugzeugtrдger=авианосец
Fluor=фтор
fluoreszierend=флуоресцирующий
fluoridieren=фторировать
Fluorverbindung=фтор.соединение
Fluss=река
Flussarm=рукав в дельте реки
Flusskrebs=речной рак
Flusspferd=бегемот
Flut=прилив
Flдche in Hektar=площадь в акрах
Flдschchen=бутылочка
Flцte=флейта
FlцЯholz=сплавной лес
flьchtig=мимолетный
flьchtig ansehen=мельком взглянуть
Flьchtling=беженец
Flьgel=крыло
Flьssigkeit=жидкость
flьstern=шептать
Fokus=фокус
folgen nach=следовать за
folgend=следующий
folgerichtig=последовательный
Folgerung=следствие
folglich=следовательно
folgt=следует
Fonds=фонд
Forderung=требование
Form=форма
Formierung=формирование
Formulierung=формулировка
Fort=форт
fortgehen=уходить, уйти
fortkriechen=уползать
fortlaufend=последовательный
fortschreitend=поступательный
Fortschritt=прогресс
Forum=форум
Fossil=ископаемое
Foto=фото
Fotografie=фотография
Fotokopierer=ксерокс
Fracht=груз
Frachtluke=грузовой люк
Frachtraum=место для багажа
Frage=вопрос
fragen=спрашивать
Fragment=фрагмент
Franc=франк
Frankreich=Франция
Franse=бахрома
Fransosin=француженка
Franzose=француз
franzцsisch=французский
frappieren=ошеломлять
Frau=женщина
Frauen=жены
frech=дерзкий
frei=свободный
freigebig=щедрый
Freigebigkeit=щедрость
Freiheit entziehen=лишать свободы
freilassen=освобождать, освободить
freisprechen=оправдывать
freistehend=незанятый
Freitag=пятница
freiwillig=добровольный
Freiwillige=доброволец
Fremde=иноземец
fressen=пожирать
Freude=радость
Freudenruf=ободрение
freudig=радостный
Freund=друг
freundlich=дружеский
Freundschaft=дружба
Freundschaften=дружба
Frieden=мир
Friedhof=кладбище
friedlich=мирный
Frikadelle=фрикаделька
Frisbee=фрисби
Friseur=парикмахер
Frisur=прическа
fromm=набожный
frontal=лобовой
Frost=мороз
Frostbeule=пучина
Frostschutz=антифриз
fruchtbar=плодородный
Fruchtbaum=плодовое дерево
Fruchtbonbon=леденец
Fruchtknoten=завязь
Frьchte=плоды
frьh=рано
frьher=раньше
Frьhling=весна
Fundament=фундамент
funkeln=искриться
funkelnd=сверкающий
Funktion=функция
Funktionieren=функционирование
Furche=борозда
furchltlos=бесстрашный
furchtsam=пугливый
Furnier=фанера
Furt=брод
Futter=корм для скота
Futteration=рацион
Futterkrippe=кормушка
Futurum=будущее время
FuЯ=нога (ступня)
FuЯball=футбол
FuЯballspiel=футбол
FuЯband=ножной браслет
FuЯbank=скамеечка для ног
FuЯnote=сноска
FuЯspitze=носок
FuЯspur=след
Fдhigkeit=способность
Fдhre=паром
fдlschen=подделывать
Fдlschung=фальсификация
Fдnger=ловушка
Fдsschen=бочонок
FдЯchen=бочонок
fцderal=федеральный
Fцderation=федерация
Fцhre=сосна
Fцrdergestell=клеть подъемника
Fцrster=лесник
Fьchsin=лисица
fьgen=присоединять
fьhlen=чувствовать
Fьhler=щупальце
fьhren=вести
Fьhrer=лидер
fьllen=наливать
Fьllung=наполнение
fьnf=пять
Fьnfmarkstьck=пятимарковая монета
fьnfzehn=пятнадцать
fьnfzig=пятьдесят
fьttern=кормить
FьЯchen=ножка
G=гэ
Gabe=доза
Gabel=вилка
gackern=кудахтать
Gackern=кудахтанье
Gage=жалованье
Galaxis=галактика
Galerie=галерея
Galgen=виселица
Galle=желчь
Gallone=галлон
Galopp=галоп
Galoschen=галоши
Gamaschen=детские рейтузы
Gang=походка
Gangart=походка
Gangster=гангстер
Gans=гусь
Ganter=гусак
Garage=гараж
Garantie=гарантия
Gardenie=гардения
Garderobe=гардероб
gargeln=полоскать горло
Garn=пряжа
Garnitur=комплект
Garten=сад
Gartenhaus=павильон
Gartennelke=гвоздика садовая
Gartenschere=садовые ножницы
Gartenschlauch=огородный шланг
Gas=газ
Gashebel=дроссельный рычаг
Gast=гость
Gastfreudschaft=гостеприимство
Gastwirt=хозяин гостиницы
Gattin=супруга
gaufrieren=гофрировать
Gauner=мошенник
Gazelle=газель
gebackene Bohnen=печеная фасоль
gebackene Kartoffeln=жаренный картофель
geben=давать
Gebet=молитва
Gebiet=район
gebildet=грамотный
Gebirgsvorland=предгорье
gebissen=укушенный
geboren=рожденный
gebracht=принесенный
gebraten=жареный
gebraucht=подержанный
gebrochen=разбитый
gebrochener Knochen=сломанная кость
Geburt=рождение
Geburtsort=место рождения
Geburtstag=день рождения
Gebдck=печенье
Gebдude=здание
gebьhrend=подобающий
Gedanke=мысль
gedeihen=преуспевать
Gedeihen=процветание
Gedicht=стихотворение
gediegenes Metall=самородок
Geduld=терпение
Geduldsspiel=головоломка
gedungener Mцrder=наемный убийца
Gedдchtnis=память
gedдmpftes Fleisch=тушеное мясо
Gefahr=риск
gefahrlos=безопасный
gefallen=упавший
Gefallen tun=делать одолжение
gefangen=пленный
Gefechtsordnung=боевой порядок
Gefieder=оперение
geflochtener Korb=плетеная корзина
Geflьgel=домашняя птица
geflьgelt=крылатый
Gefolge=свита
gefrieren=замерзший
gefrieren lassen=замораживать
Gefrierpunkt=температура замерзания
Gefrierung=замораживание
gefдhrden=подвергать опасности
gefдhrlich=опасный
Gefдngnis=тюрьма
GefдЯ=сосуд
Gefьhl=чувство
gefьhllos=бесчувственный
gefьhlslos=бесчувственный
gefьhlsmдЯig=эмоциональный
gegeben=данный
gegebene GrцЯe=данная величина
gegen=против
gegen den Uhrzeiger=против часовой стрелки
Gegenfeuer=встречный огонь
Gegengift=противоядие
Gegensatz=контраст
gegenseitig=противоположный
gegenьber=напротив
Gegner=противник
Gehalt=жалованье
gehangen=повешенный
geheim=скрытый
geheime Abstimmung=тайное голосование
Geheimnis=тайна
geheimnisvoll=таинственный
gehen=идти
Gehirn=мозг
Gehirnattacke=мозговая атака
gehorchen=слушаться
gehorsam=послушный
geht=идет
Gehдnge=подвеска
Gehцr=слух
gehцren=принадлежать
gehцrnt=рогатый
geifern=брызгать слюной
Geige spielen=играть на скрипке
Geiger=скрипач
Geigerzдhler=счетчик Гейгера
Geisel=заложник
Geist=дух, душа
geisteskrank=душевнобольной
Geistesstцrung=умопомешательство
geistig=духовный
Geistlichkeit=духовенство
Geistmunterkeit=бодрость духа
geizig=скупой
geiziger Mensch=скупец
GeiЯblatt=жимолость
Gekreische=визг
Gelage=пир
gelb=желтый
Geld=деньги
geldlich=денежный
Geldstrafe=денежный штраф
Gelee=желе
Gelegenheit=удобный случай
Gelehrte=ученый
Gelehrter=ученый
Gelehrtheit=ученость
Geleit=эскорт
Gelenk=сустав
geliebt=возлюбленный
Geliebte=возлюбленный
Gelдnder=перила
Gelьbde=обет
gemacht=сделанный
Gemahl=муж
Gemeinde=община
gemeinsam=совместный
Gemeinschaft=общность
Gemessenheit=размерность
gemдЯigt=умеренный
Gemьse=овощной
Gemьsehдndler=зеленщик
Gemьsemarkt=плодоовощной рынок
Gemьseragout=овощное рагу
gemьtlich=удобный
Gen=ген
genannt=названный
genau=подробный
Genauigkeit=точность
Generation=поколение
Generator=генератор
Genie=гений
genieЯen=наслаждаться
Gentleman=джентльмен
genug=довольно
Geographie=география
geographisch=географический
Geologie=геология
geologisch=геологический
Geometrie=геометрия
geometrisch=геометрический
Gepard=гепард
gepunktet=в горошек
Gepдck=багаж
Gepдckstelle=место для багажа
Gepдcktrдger=носильщик
gerade=прямо
gerade Linie=прямая линия
gerademachen=выпрямлять
Geranium=герань
gerben=дубить
gerecht=справедливо
gerichtlich=судебный
Gerichtsbeamte=судебный шериф
Gerichtsgebдude=здание суда
Gerichtsvollzieher=судебный пристав
Gerippe=скелет
Gerste=ячмень
Geruch=запах
Gerдt=снаряд
gerдumig=просторный
Gerьcht=молва
Gerьst=помост
gesalzen=засаленный
Gesamtmenge=общее количество
geschehen=случаться
gescheit=сообразительный
Geschenk=подарок
Geschichte=история
geschickt=проворный
Geschirr=посуда
Geschirrschrank=шкаф для посуды
geschlafen=спящий
geschlossen=закрытый
geschlummert=дремлющий
Geschmack=вкус
geschmacklos=безвкусный
geschmolzen=расплавленный
geschraubt=витиеватый
Geschwindigeitsmes.=спидометр
Geschwindigkeit=скорость
geschwollen=опухший
Geschworene=суд присяжных
Geschworenenbank=место присяжных
Geschwulst=опухоль
Geschwдtz=болтовня
Geschwьr=нарыв
Geschдft=магазин
geschдftig sein=суетиться
Geschдftsfrau=деловая женщина
gesellig=общительный
Gesellschaft=общество
gesellschaftlich=общественный
Gesetz=закон
gesetzgebend=законодательный
Gesetzgebung=законодательство
gesetzlich=законный
Gesicht=лицо
Gesichtsfarbe=цвет лица
Gesichtssinn=зрение
Gesichtswasser=туалетная вода
gespanntes Seil=натянутый канат
Gesprдch=разговор
gesprдchig=разговорчивый
Gestalt=фигура
Geste=жест
gestehen=признавать
Gestell=шасси
gestern=вчера
gestreift=в полоску
Gesuch=заявление
gesund=здоровый
Gesundheit=здоровье
GesдЯ=ягодицы
Getrдnk=напиток
Getrдnkestand=стойка для напитков
Gewalt=насилие
gewaltig=огромный
Gewand=одеяние
gewandt=умелый
Gewandtheit=проворство
Gewehr=винтовка
Geweih=рог оленя
Gewicht=вес
Gewinde=резьба
Gewinn=выигрыш
gewinnen=выиграть
Gewissen=совесть
gewissenhaft=добросовестный
Gewiterwolke=грозовая туча
Gewitter=гроза
Gewohnheit=привычка
gewohnt=привычный
gewцhnlich=обычный
gewцhnliche GrцЯe=обычный размер
gewцhnlicher Brief=обычное письмо
gewцlbt=выпуклый
gezackt=зубчатый
Gezwitscher=чириканье
gezьchtet=расплодившийся
Ghetto=гетто
Gibbon=гиббон
Gier=жадность
gieЯen=лить
GieЯerei=литейный цех
GieЯkanne=лейка
Gift=яд
Gifteiche=ядовитый дубок
giftig=ядовитый
Giftpilz=поганка
Gilde=гильдия
Gin=джин
Gips=гипс
Giraffe=жираф
Girlande=гирлянда
Gitarre=гитара
Gitter=решетка
Gladiator=гладиатор
Gladiole=гладиолус
Glanz=блеск
Glas=стакан
Glasperle=бусина
Glasperlenlitze=нитка бус
glatt=ровный
Glaube=вера, верование
glauben=верить
gleich=подобно
gleichen=быть похожим
Gleichgewicht=равновесие
gleichgьltig=безразличный
Gleichheit=равенство
gleichmдЯig=уравновешенный
gleichvielwo=где бы то ни было
gleichzeitig=совместный
Gleis=рельс
gleiten=скользить
Gletscher=ледник
Gletscherdecke=ледниковый покров
Gliedmas-en=конечность
GliedmaЯen=конечности
Globus=глобус
Glockenklang=звон колокольчика
Glockenturm=колокольня
Glossar=глоссарий
glucksen=булькать
Glyzinie=глициния
glдnzen=ярко сиять
glдnzend=блестящий
glдtten=заглаживать
Glдubiger=кредитор
Glцckchen=колокольчик
Glьck=счастье
glьcklich=счастливый
Glьckspiel=азартная игра
Gnom=гном
Gnu=гну
gnдdig=милосердный
Gold=золото
Goldamsel=иволга
golden=золотистый
Goldfisch=золотая рыбка
Goldsucher=золотоискатель
Golf=гольф
Golfball=шар для гольфа
Golfer=игрок в гольф
Golfschlдger=клюшка для гольфа
Gondel=гондола
Gong=гонг
Gorilla=горилла
Gott=Бог
Gottesanbeterin=богомол
Gottheit=божество
Grab=могила
graben=копать
Graben=канава
Grabstein=надгробие
Grad=степень
graduierendes Yard=градуированный ярд
Graf=граф
Grafschaft=графство
Gramm=грамм
Grammatik=грамматика
grammatisch=грамматический
Granat=гранат
Granatapfel=гранат
Granate=граната
Granit=гранит
Grapefruit=грейпфрут
Graphit=графит
Gras=трава
grasfressend=травоядный
Grasfresser=травоядное животное
Gratulations=поздравительный
gratulieren=поздравлять
grau=серый
Grauen=ужас
grausam=жесткий
gravieren=гравировать
greifen=хватать
Grenze=граница; предел
griechisch=греческий
Grille=кузнечик
Grillzange=прихватка
Grimasse=гримаса
Grippe=грипп
Grislybдr=гризли
grob=грубый, неточный
grob behandeln=грубо обращаться
grober Stoff=грубая ткань
Groteske=гротеск
groЯ=большой
GroЯeltern=дедушка и бабушка
GroЯmutter=бабушка
groЯmьtig=великодушный
GroЯvater=дедушка
Grund=причина
Grundbegriff=основное понятие
Grundfarbe=основной цвет
Grundlage=основа
grundlegend=основной
grunzen=хрюкать
Gruppe=группа
Grдfin=графиня
GrцЯe=величина
grьn=зеленый
grьnden=учреждать
grьndlich=основательный
Grьndling=пескарь
Guillotine=гильотина
Gummischlauch=резиновый шланг
Gunst=милость
Guppi=гуппи
Gurgel=горло
Gurke=огурец
Guss=отливка
gut=хорошо
gut bekannt=хорошо знакомый
gutherzig=добросердечный
gutmьtig=добрый
Gutsrettung=спасение имущества
gдhnen=зевать
Gдnseblьmchen=маргаритка
gдnzlich=абсолютно
Gдrtner=садовник
Gдrtnerei=садоводство
gьnstig=благоприятный
Gьrtel=пояс
Gьrteltier=броненосец(зоол.)
Gьte=доброта
Gьter=товары
H=ха
Haar=волосы
Haaren=линька
haarig=волосатый
Haarnadel=заколка
Haarsehneiden=стрижка
haben=иметь
Habicht=ястреб
Habseligkeiten=пожитки
Hacke=кирка
Hafen=гавань
Hafer=овес
Hafergrьtze=овсянка
Hagel=град
Hahn=петух
Hahnenkamm=гребешок
Haifisch=акула
Hain=роща
halbe Portion=полпорции
Halbfinale=полуфинал
Halbinsel=полуостров
Halbkreis=полуокружность
Halbkugel=полушарие
Halbmond=полумесяц
Halbwьchsiger=подросток
halbzerstцrt=полуразрушенный
Hallo!=привет!
Hals=шея
Halsband=ожерелье
Halstuch=кашне
haltbar=прочный
halten=держать
Halter=держатель
Haltestelle=остановка
Hamburger=гамбургер
Hammel=баран
Hammelfleisch=баранина
Hammer=молоток
Hamster=хомяк
Hand=рука
Handballspiel=гандбол
Handbremse=ручной тормоз
Handel=торговый
Handelsbetrieb=коммерческое предприятие
Handelsvertrag=торговая сделка
Handelszentrum=торговый центр
handgearbeitet=ручной работы
Handgelenk=запястье
handgewebt=домотканый
Handgriff=рукоятка сабли
Handkarren=ручная тележка
Handrad=штурвал
Handschaufel=совок
Handschellen=наручники
Handschrift=почерк
Handschuh=перчатка ловушка
Handteller=ладонь
Handtuch=полотенце
Handvoll=горсть
Handwerk=ремесло
Handwerker=кустарь
Hanf=конопля
Hang=крутой скат
Harfe=арфа
Harmonie=гармония
harmonieren=гармонировать
Harn=моча
Harnblase=мочевой пузырь
Harpune=гарпун, острога
hart=жесткий
hartgekochtes Ei=сваренный вкрутую
Hartholz=твердая древесина
Hase=заяц
Haselnuss=лесной орех
Hass=ненависть
hassen=ненавидеть
Hast=суета
hastig=резкий
Haufen=куча
Haupt=глава, начальник, шеф
Hauptgewinn=главный выигрыш
Hauptkoch=шеф-повар
Hauptquartier=штаб-квартира
hauptsдchlich=основной
Haus=дом
Hausapotheke=аптечка
Hausarbeit=домашняя работа
Hausbesitzer=домовладелец
Hausboot=плавучий дом
Hausfrau=хозяйка
Hausgeflьgel=домашняя птица
Haushalt=домашнее хозяйство
Haushдlterin=экономка
Hausnummer=номер дома
Hauspflanze=домашнее растение
Haussuchung=обыск
Haustier=домашнее животное
Hausvieh=домашний скот
Hauswart=дворник
Hebebьhne=эстакада
Hebel=рычаг
heben=поднимать
Heben=поднимание
Hecht=щука
Heck=корма
Hecke=живая изгородь
Heckenrose=шиповник
Hefe=дрожжи
Heft=тетрадь
heftig=резкий
hegen=лелеять
Heide=язычник
Heidekraut=вереск
Heidelbeere=черника
Heilbutt=палтус
heilen=излечивать
heilig=священный
Heilschmiere=целебная мазь
Heimatland=родина
Heimchen=сверчок
Heimweh haben=тосковать по дому
Heirat=женитьба
heiraten=жениться
heiser=хриплый
Heizer=кочегар
Heizkцrper=нагреватель
heiЯ=горячий
heiЯe springquelle=гейзер
Hektar=гектар
Held=герой
heldenmьt=доблестный
heldenmьtig=героический
Heldentat=подвиг
Heldin=героиня
Helium=гелий
hell=светлый
Helm=шлем
Hemd=рубашка
Hemd mit kurzen Дrmln=рубашка с кор. рукавами
Hemd mit Дrmeln=рубашка с рукавами
Hemdrock=комбинация
Henkel=ушко
Henne=курица
herabgelassen=спускающийся
Herankommen=приближение
heranziehen=вовлекать
Herausforderung=вызов
herausgeben=публиковать
herausragender Zahn=торчащий зуб
herausreiЯen=выдергивать
Herbeiwinken=манящий жест
Herbst=осень
Herd=печь
Herde=стадо
herfallen=нападать
hergestellt=изготовленный
Hering=сельдь
Hermelin=горностай
Heroin=героин
Herr=мистер
herrlich=очаровательный
Herrscher=правитель
herstellen=производить
Herstellung=производство
hervorragend=выдающийся
hervorspringen=выпячиваться
Herz=сердце
herzlich=сердечный
Herzogin=герцогиня
Herzschlдge=сердцебиение
Heu=сено
Heuboden=сеновал
Heuchler=лицемер
Heugabel=вилы
heulen=выть
Heuschober=стог сена
Heuschrecke=саранча
heute=сегодня
heute Abend=сегодня вечером
heutzutage=в наше время
hier=здесь
Hilfe=помощь
hilflos=беспомощный
Hilfs=вспомогательный
Himbeeren=малина
himbeerfarben=малиновый
Himmel=небо
himmlisch=небесный
hinab=книзу
hinblicken=заглядывать
hindern=препятствовать
Hindernis=препятствие
Hinduismus=индуизм
hineingebaut=встроенный
hineinstoЯen=вонзать
hinhaltend=задержавшийся
hinken=хромать
hinsichtlich=относительно
hinten=сзади
hinter=задний
hinter dem Heck=за кормой
Hinterbacke=ягодицы
Hintergrund=фон
Hinterhalt=засада
Hinterhof=задний двор
Hintertьr=задняя дверь
Hinweis=указание
Hippopotamus=гиппопотам
Hirsch=олень
Hirschfleisch=оленина
Hirschkalb=молодой олень
historisch=исторический
Hobby=хобби
Hobel=рубанок
Hobelspдne=стружка
hoch=высокий
hochfliegen=высоко летать
Hochhaus=высотный дом
hochmьtig=высокомерный
Hochschдtzung=высокая оценка
Hochsitz=место спасателя
hochstieben=вздыматься
Hochverrat=государственная измена
Hochzeit=свадьба
hocken=сидеть на корточках
Hocker=табурет
Hof=двор
Hoffnung=надежда
hoffnungslos=безнадежный
Hofmeister=дворецкий
Hoheit=высочество
holen=принести
hollдndisch=голландский
Holz=древесный
Holzfдller=дровосек
Holzhammer=киянка
Holzkohle=древесный уголь
Holzscheit=полено
Holzteller=деревянная тарелка
Holzverarbeitung=обработка древесины
homogenisieren=гомогенизировать
Homograph=омограф
Homonym=омоним
Homophon=омофон
Honig=мед
Honigmonat=медовый месяц
Honigscheibe=соты
horchen=подслушивать
Horde=орда
Hormon=гормон
Horn=горн
Hornhaut=роговица
Hornisse=шершень
Hornist=горнист
Hose=брюки
Hosentrдger=подтяжки
Hotel=отель
Hubschrauber=вертолет
Huf=копыто
Hufeisen=подкова
Hummel=шмель
Humor=юмор
humoristisch=юмористический
Humus=перегной
Hund=собака
Hundehьtte=собачья конура
hundert=сто
Hundertgrad=стоградусный
Hunger=голод
hungern=голодать
hungrig=голодный
Hupe=гудок
hurra!=ура!
Husten=кашель
Hut=шляпа
Hyazinthe=гиацинт
Hybrid=гибрид
Hydrand=гидрант
hydroelektrisch=гидроэлектрический
Hygiene=гигиена
Hymne=гимн
hypnotisieren=гипнотизировать
Hypotenuse=гипотенуза
hysterisch=истерический
Hyдne=гиена
Hдkelnadel=крючок для вязания
Hдlfte=половина
Hдndedruck=рукопожатие
hдndeln=торговать вразнос
Hдndler=коммерсант
Hдngematte=гамак
Hдngemotor=подвесной мотор
hдngen=вешать
Hдngeschloss=висячий замок
hдrten=закалять
hдufig=частый
Hдufigkeit=частота
hдutchenartige=перепончатоногий
hцchst=весьма
Hцchstpersцnlich=собственная персона
hцflich=вежливый
Hцflichkeit=вежливость
Hцhe=высота
Hцhenmesser=высотомер
Hцhle=пещера
Hцhlung=впадина
hцhnisch=саркастический
Hцlle=ад
hцlzern=деревянный
hцrbar=слышимый
hцren=слышать
Hьfte=бедро
Hьgel=крутой холм
hьgelig=холмистый
Hьhnerstall=курятник
Hьhnerstange=насест
Hьlse=стручок
hьndisch=собачий
hьten=хранить
Hьtte=хижина
I=и
ideal=идеальный
Idee=идея
identifizieren=отождествлять
identisch=идентичность
Idiom=идиома
Idiot=идиот
Idol=идол
Igel=еж
Iglu=иглу
ignorieren=игнорировать
ihr=ваш
illegal=нелегальный
Illustrator=иллюстратор
illustrieren=иллюстрировать
Iltis=хорек
im Namen=от имени
im Netz fangen=поймать в сети
im Schrecken=в ужасе
im voraus=заранее
Imbissstube=закусочная
Imitation=имитация
immer=всегда
Immigration=иммиграция
immun=иммунный
Immunitдt=иммунитет
Imperatorin=императрица
Imperfekt=имперфект
impfen=делать прививку
Impfstoff=вакцина
Impfung=вакцинация
Import=импорт
in der Nachbarschaft=по соседству
in der Nдhe=поблизости
in die Enge treiben=ставить в тупик
in die Falle Geraten=поймать в ловушку
in Richtung von=по направлению к
in Scheiben schneiden=резать дольками
in Wut bringen=бесить
Index=индекс
Indianer=индеец
Indien=Индия
Indigo=индиго
indirekt=косвенный
indisch=индийский
Individualitдt=индивидуальность
individuell=индивидуальный
indolent=инертный
Indonesien=Индонезия
Industrie=промышленность
industriell=промышленный
Infanterie=пехота
Infizierung=инфузория-туфелька
Inflation=инфляция
Information=информация
informieren=информировать
Ingwerkuchen=имбирный пряник
Inhalt=сюжет
Initial=инициал
Initiative=инициатива
Inka=инка
inkrustieren=инкрустировать
Inkubator=инкубатор
innen=внутри
Innenhof=внутренний двор
Innenland=внутренняя часть страны
inner=внутренний
innerhalb=внутри
inoffiziell=неофициальный
ins Ausland=за границу
Inschrift=надпись
Insekt=насекомое
Insel=остров
Inselchen=островок
Inspektor=инспектор
instabil=нестабильный
Installateur=водопроводчик
Instinkt=инстинкт
instinktmдЯig=инстинктивный
Institut=институт
Institution=учреждение
instruieren=инструктировать
Instruktion=инструктаж
Instrument n=инструмент
Integration=интеграция
Integritдt=целостность
Intellekt=интеллект
intellektuell=интеллектуальный
Intensitдt=интенсивность
interessant=интересный
Interesse=интерес
intern=интерн
international=международный
Internist=терапевт
interplanetar=межпланетный
interpretieren=интерпретировать
Interpunktion=пунктуация
Interview=интервью
intransitives Verb=непереходный глагол
Intrige=интрига
Invalide=калека
Inventar=инвентарь
Ion=ион
Iordan=Иордан
Irak=Ирак
Iran=Иран
irgend jemand=кто-нибудь
irgendswo=где-нибудь
irgendwann=когда-нибудь
irgendwo=где-нибудь
Iris=радужная оболочка
irisch=ирландский
Irland=Ирландия
Irokese=ирокезы
Ironie=ирония
irrefьhren=вводить в заблуждение
Irrefьhrung=обман
Irrgarten=лабиринт
irrig=ошибочный
isolieren=изолировать
Isolierung=изоляция
israelisch=израильский
italienisch=итальянский
J=йот
j-n behandeln=обращаться с кем-либо
ja=да
Jacht=яхта
Jacke=куртка, пиджак
Jagd=охота
Jagdflugzeug=самолет-истребитель
Jagdhund=охотничья собака
jagen=преследовать
Jaguar=ягуар
Jahr=год
Jahreseinkommen=годовой доход
Jahrestag=годовщина
Jahreszeit=время года
Jahrhundert=век
Jahrmarkt=ярмарка
Jahrmarktplatz=ярмарочная площадь
Jahrzehnt=десятилетие
Jak=як
Jamaika=Ямайка
Januar=январь
Japan=Япония
japanisch=японский
Jawohl!=есть!
Jazz=джаз
Jeans=джинсы
jedenfalls=в любом случае
jeder=каждый
jeder von ihnen=каждый из них
jederzeit=всегда, в любое время
Jeep=джип
jemand=кто-то
Jen=иена
jene=те
jener=тот
Jesus=Иисус
jetzt=сейчас
Jockey=жокей
Jod=йод
Joghurt=йогурт
jonglieren=жонглировать
Journalismus=журналистика
Journalist=журналист
Jucken=зуд
Judaismus=иудаизм
Jude=еврей
judisches Neujahr=еврейский Новый год
Judo=дзюдо
Jugend=молодость
Jugendlich=подросток
Juli=июль
jung=молодой
Junge=детеныш
junge Gans=гусенок
Jungenrahmen=рама для юношей
junger Hund=щенок
jungfrдulich=девственный
Juni=июнь
Junior=юниор
Jupiter=Юпитер
juristisch=юридический
Jute=джут
Juwelier=ювелир
Jдger=охотник
jдhrlich=годовой
jдmmerlich=жалкий
jьdisch=еврейский
jьdisches Fest=еврейский праздник
Jьngling=юнец
jьngste=младший
K=ка
Kabale=коварство
Kabel=кабель
Kabelauto=электроконка
Kabeljau=треска
Kabine=кабина
Kabinett=кабинет
Kachel=плитка
Kadett=кадет
Kaffee=кофе
Kaffeekanne=кофейник
Kaffeetisch=кофейный столик
kahl=лысый
Kahn=челнок
Kai=набережная
Kaiser=император
Kajak=каяк
Kajal=карандаш для бровей
Kakadu=какаду
Kakao=какао
Kaktus=кактус
Kalb=теленок
Kalbfleisch=телятина
Kaleidoskop=калейдоскоп
Kalender=календарь
Kaliko=коленкор
Kalium=калий
Kalkstein=известняк
Kalligraphie=каллиграфия
Kalmar=кальмар
kalt=холодный
Kaltwasserhahn=кран холодной воды
kam=пришел
Kambodia=Камбоджа
Kamel=верблюд
Kameramann=кинооператор
Kamerun=Камерун
Kamin=камин
Kaminplatz=место у камина
Kaminsims=каминная полка
Kamisol=камзол
Kamm=расческа
Kammer=камера
Kampf=бой
Kampfer=камфара
Kampffeld=поле боя
Kampfhandlungen=боевые действия
Kampfpferd=боевой конь
Kanadier=каноэ
Kanal=канал
Kanarienvogel=канарейка
Kandidat=кандидат
Kaninchen=кролик
kann nicht=не могу
Kannibale=людоед
Kanone=пушка
Kanzleitisch=канцелярский стол
Kanzler=канцлер
Kap=мыс
Kapelle=часовня
Kapillare=капилляр
Kapital=капитал
Kapital anlegen=вкладывать капитал
kapitalisieren=капитализировать
Kapitalismus=капитализм
Kapitol=Капитолий
Kapitulation=капитуляция
Kapitдn=капитан
Kappe=кепка
Kapsel=капсула
Karat=карат
Karawane=караван
Kardinal=кардинал
karibisch=карибский
Karibu=карибу
Karneval=карнавал
Karosserie=кузов
Karpfen=карп
Karriere=карьера
karriert=в клетку
Karte=карта
Karteikarte=библиотечная карточка
Karten=картонный
Kartengeber=агент по продаже
Karteninhaber=абонент
Kartennummer=номер карточки
Kartentasche=планшир
Kartoffelbrei=картофельное пюре
Kartoffelkдfer=колорадский жук
Kartoffeln=картофель
Karton=картонная упаковка
Karussel=карусель
Kaschmir=кашемир
Kaserne=казарма
Kaskade=каскад
Kasse=касса
Kassette=кассета
Kassettendeck=кессонный потолок
Kassettenplayer=кассетный плейер
Kassier=казначей
Kastagnetten=кастаньеты
Kastanie=каштан
Katalog=каталог
Katastrophe=бедствие
Kater=кот
Katfisch=зубатка полосатая
Katheder=кафедра
Kathedrale=собор
katolisch=католический
Katze=кошка
Katzenbдr=панда
kaufen=покупать
Kaulbarsch=ерш
Kaulquappe=головастик
kaum=едва
Kegel=конус
Kegelball=шар кегельбана
kehren=подметать
Keil=клин
Keim=зародыш
keimen=прорастать
Keimling=эмбрион
kein=никакой
Kelchblatt=чашелистник
Kelle=ковш
Keller=хозблок
Kellner=официант
Kellnerin=официантка
Kenner=знаток
Kenntnis=знание
Kennwort=пароль
Keramik=керамика
keramisch=керамический
Kerbe=засечка
Kerker=темница
Kern=ядро
Kerze=свеча
Kerzenhalter=подсвечник
Ketchup=кетчуп
Kette=цепь
Khaki=хаки
kichern=хихикать
Kiefer=челюсть
Kiel=киль
Kieme=жабра
Kiesel=галька
Kilogramm=килограмм
Kilometer=километр
Kilowatt=киловатт
Kilt=килт
Kimono=кимоно
Kinder=дети
Kinderarzt=педиатр
Kinderfrau=нянька
Kindergarten=детский сад
Kinderpuder=детская присыпка
Kinderrassel=погремушка
Kindersitz=детское сиденье
Kinderstadt=детский городок
Kinderstuhl=детский стул
Kinderwagen=детская коляска
Kinderzimmer=детская комната
Kindheit=детство
kindisch=ребяческий
Kinn=подбородок
Kipper=самосвал
Kipplaster=самосвал
Kirche=церковь
Kirsche=вишня
Kissen=подушка
Kissenbezug=наволочка
Kitt=замазка
Kittel=китель
kitzeln=щекотать
Kitzeln im Halse=першение в горле
Kiwi=киви
klagen=жаловаться
Klammer=скобка
Klammerentferner=скобосниматель
Klapperschlange=гремучая змея
Klapptisch=откидной столик
klar=ясный
Klarinette=кларнет
Klasse=класс
Klassenzimmer=классная комната
klassifizieren=классифицировать
klassisch=классический
Klaue=коготь
Klavichord=клавикорд
Klavier=рояль
kleben=прилипать
klebengeblieben=прилипший
Klebestreifen=липкая лента
klebrig=клейкий
Klee=клевер
Kleid=платье
Kleider=одежда
Kleiderrechen=вешалка
Kleidung=одежда
Kleidungsartikel=предмет одежды
Kleidungstasche=сумка для одежды
Kleie=отруби
klein=мелкий
Kleinere=меньший
kleines Lastauto=пикап
Kleingarnelle=мелкая креветка
Kleinigkeit=пустяк
Kleinkamera=детский фотоаппарат
Klemme=клемма
Klemme fьr Wattebausch=зажим для тампонов
klettern=карабкаться
Klient=клиент
Klima=климат
Klimax=климакс
Klingel=звонок
klingeln=звонить
Klingen=звонок
Klipper=клипер
klirren=дребезжать
Klirren=звяканье
Klobьrste=вантуз
klopfen=стучаться
Klopfen=похлопывание
Kloster=монастырь
klug=умный
Klumpen=глыба, ком
klдglich=жалостный
Klьver=кливер
Klьverbaum=утлегарь
Knaben=отроческий
Knabenalter=отрочество
knallen=хлопать
knarren=скрипеть
kneifen=ущипнуть
Knicks=реверанс
Knie=колено
knien=стоять на коленях
Kniescheibe=коленная чашка
Knirschen=хруст
knirschig=хрустящий
knittern=комкать
Knoblauch=чеснок
Knoblauchstьck=долька чеснока
Knochen=кость
Knochenmark=костный мозг
Knochenschwiele=костная мозоль
knochig=костистый
Knopf=пуговица
Knorpel=хрящ
knorrig=сучковатый
Knospe=бутон
Knoten=узел
knotig=узловатый
Knцchel=щиколотка
Knьppel=дубинка
Koala=коала
Kobalt=кобальт
Kobra=кобра
kochen=варить
Koffer=плоский чемодан
Kofferraum=багажник
Kohle=уголь
Kohlenhydrat=углевод
Kohlenmonoxyd=угарный газ
Kohlenstoff=углерод
Kohlsalat=салат из капусты
Kojote=койот
Kokon=кокон
Kokos=кокос
Kokosnuss=кокос
Koks=кокс
Kolben=колба
Kolibri=колибри
Kollege=коллега
Kolombine=коломбина
kolonial=колониальный
Kolonialwarenbude=бакалейная лавка
Kolonisator=колонизатор
kolonisieren=колонизировать
Kolumbien=Колумбия
Kombination=комбинация
Kombьse=камбуз
Komfort=комфорт
Komiker=комик
komisch=комичный
Kommandeur=командир
kommandieren=командовать
Kommando=команда
Kommandomodul=командный модуль
Kommentator=комментатор
Kommerz=коммерция
kommerziell=коммерческий
Kommunismus=коммунизм
Kompagnon=компаньон
kompakt=компактный
Kompaktdisk=компакт-диск
Kompass=компас
kompetent=компетентный
Komplex=комплекс
Komplikation=усложнение
Kompliment=комплимент
kompliziert=замысловатый
Komponist=композитор
Kompost=компост
Kompromiss=компромисс
Kondor=кондор
Konfektion=конвекция
Konferenz=конференция
Konflikt=конфликт
Konfцderation=конфедерация
Kongo=Конго
Kongress=конгресс
Kongressfrau=женщина-конгрессмен
Kongressmitglied=конгрессмен
konkav=вогнутый
konnte=мог
konservativ=консервативный
Konserven=консервы
Konservenbьchse=консервная банка
Konsonant=согласный звук
Konspiration=конспирация
Konstabler=констебль
Konstitution=строение
Konstruktion=конструкция
Konsul=консул
Kontakt=контакт
Kontext=контекст
Kontinent=континент
Konto=платежный счет
Kontraalto=контральто
Kontrabass=контрабас
Kontrollkasse=контрольная касса
Kontur=контур
Konzentration=концентрация
Konzeption=концепция
Konzert=концерт
Koordination=координация
koordinieren=координировать
Kopf=голова
Kopfbedeckung=головной убор
Kopfbinde=повязка на голове
Kopfhцrer=наушники
Kopfkohl=капуста кочанная
Kopfschmerz=головная боль
Kopfschuppen=перхоть
Kopfstьtze=подголовник
Kopftuch=косынка
kopieren=копировать
Koralle=форель
Koran=Коран
Korb=корзина
koreanisch=корейский
Korkenzieher=штопор
Korn=зерно
Kornelkirschbaum=кизил
Kornett=корнет
Korporal=капрал
Korpuskel=корпускула
Korrektur=коррекция
Korrektur lesen=читать корректуру
Korrespondent=корреспондент
Korrespondenz=корреспонденция
korrigieren=исправлять
Korrosion=коррозия
koscher=кошерный, чистый
kosmetik=косметика
Kosmetik=косметика
kosmetisch=косметический
kosmisch=космический
kosmische Sonde=космический зонд
kosmische Station=космическая станция
Kosmonaut=космонавт
Kosmos=космос
Kosmosausgang=выход в космос
kostbar=драгоценный
Kotelett=котлета
Krabbe=краб
Krachmache=хлопушка
Kraft=сила
kraftlos=немощный
Kragen=воротник
Krake=осьминог
Krampf=судорога
Kran=кран
Kranke=больной
Krankenhaus=больница
Krankenschwester=медсестра
krankhaft=болезненный
Krankheit=болезнь
Kranz=венок
Krater=кратер
kratzen=царапать
Krawatte=галстук
Krawattenklipp=прижим для галстука
Krawattennadel=брошь для галстука
Kreatur=живое существо
Krebs=рак
Krebsschere=клешня
Krebstiere=ракообразные
Kredit=кредит
Kredo=кредо
Kreide=мел
Kreideschale=лоток для мела
Kreis=круг
Kreisabschnitt=сегмент
Kreisbogen=круглая арка
kreischen=хрипло кричать
Krepp=креп
Kresse=настурция
Kreuz=поясница
Kreuzchen=крестик
Kreuzfahrer=крестоносец
Kreuzung=пересечение
Kreuzweg=перекресток
kreuzweise=крест-накрест
Kreuzwortrдtsel=кроссворд
kriechen=ползать
Krieg=война
Krieger=воин
kriegfьhrend=воюющий
Kriegsbeil=томагавк
kriegsmarine=военно-морской
Kriegsmarine=военно-морской флот
Kriegsschiff=военный корабль
Kriekente=чирок
Kriminal=детективный
Krippe=детская кровать
Krise=кризис
Kristall=кристалл
kristallisieren=кристаллизовать
Kritik=критика
Kritiker=критик
kritisch=критический
kritisieren=критиковать
Krocket=крокет
Krokodil=крокодил
Krokus=крокус
Krone=корона
Kronleuchter=люстра
Krug=кружка
krumm=криво
krummbeinig=кривоногий
Kruppe=круп
Krдcker=крекер
krдftig=сильный
Krдhe=ворона
Krцnungszeremonie=коронация
Krцte=жаба
Krьcke=костыль
Krьmel=крошка
krьmeln=крошить
Kuba=Куба
kubisch=кубический
Kuckuck=кукушка
Kugel=пуля
Kugelschreiber=ручка
Kuh=корова
Kuhstahl=коровник
Kulmination=кульминация
Kult=культ
Kultur=культура
kulturell=культурный
Kummer=горе
Kummet=хомут
Kunst=искусство
Kunstreiter=наездник
Kupfer=медь
Kupferstich=гравюра
Kupon=купон
Kuppel=купол
Kupplung=сцепление
Kurator=попечитель
Kurbel=кривошип, мотыль, колено
Kurs=курс
Kursiv=курсив
Kursiv hervorheben=выделять курсивом
Kurve=кривая
kurz=короткий
kurze Hose=шорты
kurze Stockung=короткая заминка
kurzsichtig=близорукий
Kuss=поцелуй
Kдfer=жук
Kдferchen=жучок
Kдfig=клетка
kдmpfen=бороться
Kдmpfer=боец
Kдnguruh=кенгуру
Kдse=сыр
Kдserei=сыроварня
Kдstchen=бардачок
Kдtzchen=котенок
Kцder=наживка
Kцnig=король
Kцnigin=королева
kцniglich=королевский
Kцnigreich=королевство
Kцnigskuchen=кекс
kцnnte nicht=не мог
Kцrper=тело
Kцrperbewegung=рывок на старте
kцrperlich=телесный
Kцrperschaft=корпорация
Kьbel=чан
Kьche=кухня
Kьchenmaschine=кухонный комбайн
Kьchenschabe=таракан
Kьckenbraten=жареный цыпленок
Kьgelchen=катышек
kьhl=прохлада
Kьhler=радиатор
Kьhlschrank=холодильник
Kьhnheit=отвага
Kьken=цыпленок
kьndigen=увольнять
Kьnstler=художник
kьnstlich=искусственный
Kьrbis=тыква
Kьrbislaterne=фонарь из тыквы
kьrzen=сокращать
Kьste=побережье
Kьstengebiet=приморье
Kьstenstrich=береговая полоса
L=эл
Laboratorium=лаборатория
Laborglas=лабораторный стакан
Lache=лужа
lachen=смеяться
Lachen=смех
Lachs=лосось
Lack=лак
Lackleder=лакированная кожа
Lackmuspapier=лакмусовая бумага
Lacrosschlдger=ракетка для лакроса
laden=грузить
Laden=загрузка
Ladestock=шомпол
Ladung=груз
Lage=положение
Lager=лагерь
Lagerfeuer=костер
Lagerzone=лагерная зона
Lagune=лагуна
Laken=простыня
lallen=лепетать
Lama=лама
Lamm=ягненок
Lampe=лампа
Lampenschirm=абажур
Land=страна
Landfrau=землячка
Landgegend=сельская местность
Landhaus=коттедж
Landmesser=землемер
Landsmann=земляк
Landstreicher=бродяга
Landtruppen=сухопутные войска
Landung=высадка
Landwehrmann=ополченец
Landwirtschaft=сельское хозяйство
landwirtschaftlich=сельско-хозяйственный
lang=длинный
Langbrot=буханка
langes Horn=длинный рог
Langeweile=скука
langsam=медленно
langsam rudern=медленно грести
langweilen=надоедать
langweilig=скучный
langweilige Arbeit=нудная работа
Lanze=копье
Laos=Лаос
Lappen=тряпка
Larve=личинка
Laser=лазер
lass das=оставь это
lassen=оставлять
Lasso=лассо
lasterhaft=порочный
Lastkraftwagen=грузовик
Lasttrдger=грузчик
Lastvagenfahrer=водитель грузовика
Lastwagen=грузовик
Lastwagenfahrer=водитель грузовика
Lasurblau=лазурь
Laterne=фонарь
Lattichsalat=салат-латук
Laub=листва
Laubfrosch=лягушка
Lauf=бег
laufen=бегать
Laufen=беготня
laufend=текущий
Laufgitter=детский манеж
Lauge=щелок
Laune=каприз
launenhaft=с причудами
Laus=вошь
lauschen=подслушивать
laut=громкий
Laut=звук
Laute=лютня
Lautsprecher=громкоговоритель
Lava=лава
Lavendel=лаванда
Lawine=лавина
leben=жить
Leben=жизнь
lebendig=живой
Lebens=жизненный
Lebensdauer=продолжительность жизни
Lebensfдhigkeit=жизнеспособность
lebenslдnglich=пожизненный
Lebensweise=образ жизни
Leber=печень
Lebertran=рыбий жир
lebhaft=живо
leblos=безжизненный
lecken=лизать
Leckerbissen=лакомство
Leder=кожа
Lederarmband=кожаный ремешок
Lederpeitsche=плеть из кожи
ledig=холостой
leer=пустой
Leere=пустота
legen=класть
Legende=легенда
legendдr=легендарный
Legion=легион
Legislative=законодательный орган
legitim=законный
Leguan=игуана
Lehmschiefer=глинистый сланец
Lehrbuch=учебник
lehren=учить
Lehrer=учитель
Leib Brot=буханка
Leibeigene=крепостной
leiblich=родной
Leibwдchter=телохранитель
Leiche=труп
leichglдubig=легковерный
leicht=легкий
leicht berьhren=слегка прикасаться
leichtsinnig=легкомысленный
leict erregbar=легко возбудимый
Leid tun=причинять страдание
Leid zufьgen=причинять боль
Leidenschaft=страсть
leidenschaftlich=страстный
leider!=увы!
Leier=лира
Leim=клей
leinen=льняной
Leinцl=льняное масло
leise=тихий
leise wiehern=тихо ржать
Leiste=планка
Leistung=достижение
leiten=управлять
Leiter=лестница
Leiterin=начальница
Leiterwagen=телега
Leitung=руководство
Leitwerk=эстакада
Lektion=урок
Lektьre=чтение
Lenkstange=руль велосипеда
Leopard=леопард
Lerche=жаворонок
lesen=читать
Leser=читатель
leserlich=читаемый
leuchten=сиять
leuchtend=светящийся
Leuchtkдfer=светлячок
Leuchtturm=маяк
Leute=люди
Leutnant=лейтенант
Libelle=стрекоза
Licht=освещение
Lichtjahr=световой год
Lichtpause=светокопия
Lichttarnung=светомаскировка
lichtundurchlдssig=светонепроницаемый
lieb=любящий
lieben=любить
liebenswьrdig=любезный
Liebhaber=любитель
Liebling=излюбленный
Lieblings=излюбленный
Lied=песня
Lieferant=поставщик
liefern=доставлять
Lieferung=доставка
Liegestuhl=шезлонг
Likцr=ликер
Lilie=лилия
Limabohne=лимская фасоль
Limonade=лимонад
Limone=лимон
Linde=липа
Lineal=линейка
Linksbahn=левая полоса
Linkshдnder=левша
Linoleum=линолеум
Lippe=губа
Lippenstift=губная помада
lispeln=шепелявить
Liter=литр
Literatur=литература
loben=хвалить
Loch=дыра
lochen=дырявить
Locke=локон
lockig=вьющийся
Lockung=приманка
Loganbeere=логанова ягода
Logenplatz=место в ложе
Logik=логика
logisch=логический
logo=логотип
Lohn=заработок
Lohnsteuer=подоходный налог
lokal=местный
Lokomotive=локомотив
Lokomotivfьhrer=машинист
Lorbeerbaum=лавровое дерево
Los=жребий
loslassen=пускать
LosreiЯen=отрыв
Losung=лозунг
Lot=перпендикуляр
Lotos=лотос
Luchs=рысь
Luft=воздух
Luftballon=воздушный шар
Luftfilter=воздушный фильтр
Luftmatratze=надувной матрац
Luftpost=авиапочта
Luftpumpe=пневматический насос
Luftrцhre=дыхательное горло
Luftschiff=дирижабль
Luftspiegelung=мираж
Lufttank=бак с воздухом
luftundurchlдssig=воздухонепроницаемый
Luftventil=воздушный клапан
Luftwaffe=ВВС
Luke=люк
Lunge=легкое
Lungenentzьndung=пневмония
Lupe=лупа
Lurch=земноводное
Lurche=земноводные
lustig=радостно
lustlos=неохотный
luxuriцs=роскошный
Luxus=роскошь
Luzerne=люцерна
Lymphe=лимфа
Lyrik=лирика
lyrisch=лирический
Lдcheln=улыбка
lдcherlich=смехотворный
Lдmpchen=фонарик
lдndlich=сельский
Lдnge=долгота
lдnglich=продолговатый
Lдrche=лиственница
Lдrm=шум
lдrmend=шумно
lдstig=надоедливый
Lдstigkeit=недоедание
Lдtzchen=нагрудник
Lдufer=бегун
Lдuse=вши
Lцffel=ложка
lцschen=гасить
Lцschfahrzeug=пожарная машина
Lцsegeld=выкуп
lцsen=развязывать
lцslich=растворимый
Lцsung=решение
lцten=паять
Lцtlampe=паяльная лампа
Lцwe=лев
Lцwendompteur=укротитель львов
Lцwenmaul=львиный зев
Lцwenzahn=одуванчик
Lцwin=львица
Lьftchen=ветерок
Lьftung=вентилятор
lьgen=обмануть
M=эм
machen=делать
Macht=власть
machte=делал
Madame=мадам
Mademoiselle=мадемуазель
Magen=желудок
Magenschmerz=боль в желудке
Magenschmerz m=боль в желудке
Magie=магия
Magier=маг
magisch=магический
Magma=магма
Magnesium=магний
Magnet=магнит
magnetisch=магнитный
magnetisieren=намагничивать
Magnetismus=магнетизм
mahlen=молоть
Mahnung=напоминание
Mai=май
Mais=кукуруза
Maisbrei=мамалыга
Maisfladen=маисовая лепешка
Maismehl=кукурузная мука
Maisstrung=стержень кукурузы
majestдtisch=величавый
Makkaroni=макароны
Makrele=скумбрия
Makrone=макрон
Mal=раз
Malaria=малярия
Malavien=Малави
Malaysia=Малайзия
malerisch=живописный
Malz=солод
Mammut=мамонт
Manager=управляющий
manchmal=иногда
Mandarine=мандарин
Mandelkern=миндалины
Mandeln=миндаль
Mandoline=мандолина
Mangel=недостаток
Mango=манго
Mangolie=магнолия
Manguste=мангуста
Manier=манера
Manikьre=маникюр
Mann=мужчина
Mannbarkeit=возмужалость
Mannschaft=команда
Manschettenknцpfe=запонки
Mantel=пальто
Manцver=маневр
Marathonlauf=марафон
Margarine=маргарин
Marienkдfer=божья коровка
Marineinfanterie=морская пехота
Marineinfanterist=морской пехотинец
Mark=костный мозг
Marke=талон
Markierung=маркировка
Marktplatz=рыночная площадь
Marmelade=джем
Marmor=мрамор
Marokko=Марокко
Marqui=маркиз
Marquise=маркиза
Mars=Марс
Marschall=маршал
Marschroute=маршрут
Maryland=Мэриленд
Maschine=механизм
Maschinengewehr=пулемет
Maschinenschaden=поломка механизма
Maschineschreiberin=машинистка
Maschinist=машинист
Masern=корь
Maske=маска
Maskenball=маскарад
Massachusetts=Массачусетс
Massage=массаж
Masseur=массажист
massgebend=авторитетный
massiv=массивный
Mast=мачта
Materialsammlung=сборник материалов
Mathematik=математика
Mathematiker=математик
mathematisch=математический
Matratze=матрац
Maulbeerbaum=шелковица
Maulkorb=намордник
Maultier=мул
Maurer=каменщик
Maurerkelle=кельма
Mauretanien=Мавритания
Maus=мышь
Mausefalle=мышеловка
Maximum=максимум
Mayonnaise=майонез
MaЯband=рулетка
Mechaniker=механик
mechanisch=механический
Mechanismen=механизмы
Mechanismus=механизм
Medaille=медаль
mediterran=средиземноморский
Medizin=лекарство
medizinisch=медицинский
Meduse=медуза
Meer=море
Meeralge=морская водоросль
Meerbusen=морской залив
Meerenge=узкий пролив
Meereskunde=океанография
Meermuschel=морская ракушка
Meerschweinchen=морская свинья
Megaphon=мегафон
Mehl=мука
mehr=больше
Mehrheit=большинство
meiden=избегать
Meile=миля
Meilendistanz=расстояние в милях
Meilenstein=веха
mein Lieber=дружище
meinen=полагать
Meinung=мнение
Meise=синица
Meister=чемпион
Meisterschaft=мастерство
Meisterwerk=шедевр
Melancholie=меланхолия
melden=сообщать
Melodie=мелодия
melodisch=мелодичный
Melone=дыня
Membrane=мембрана
Menge=толпа
Menora=менор
Menschen entfьhren=похищать людей
menschenleer=безлюдный
Menschheit=человечество
menschlich=гуманный
Menь=меню
Merkmal=отличительная черта
Merkur=Меркурий
Messer=нож
Messias=миссия
Messing=латунь
Messung=измерение
Metall=металл
Metalldetektor=детектор металла
metallisch=металлический
Metallstaub=металлические опилки
Metamorphose=метаморфоза
metamorphosisch=метаморфический
Metapher=метафора
Meteor=метеор
Meteorit=метеорит
Meteorologe=метеоролог
Meterologie=метеорология
Methan=метан
Methode=метод
metrisch=метрический
Metronom=метроном
Meuterei=мятеж
Meuterer=мятежник
Mexico=Мехико
mexsikanisch=мексиканский
miauen=мяукать
Michigan=Мичиган
Microcomputer=микрокомпьютер
Mieder=корсаж
mieten=нанимать
Mieter=квартиросъемщик
Mikrobe=микроб
Mikrobus=микроавтобус
Mikrofilm=микрофильм
Mikroorganismus=микроорганизм
Mikrophon=микрофон
Mikroskop=микроскоп
Mikrowellen=микроволновый
Milan=коршун
Milch=молоко
Milchbrцtchen=сдобная булочка
MilchstraЯe=Млечный Путь
Milchwagen=молоковоз
Milchzahn=молочный зуб
mild=кроткий
militдrisch=воинский
Milliarde=миллиард
Millimeterpapier=миллиметровая бумага
Millionдr=миллионер
Mime=мимик
Minarett=минарет
Minderheit=меньшинство
minderwertig=неполноценный
Minenwerfer=миномет
Mineral=минерал
Miniatur=миниатюра
Minimum=минимум
Minister=министр
Minnesota=Миннесота
minus=минус
mischen=смешивать
Mischung=смесь
Missachtung=неуважение
missbilligen=не одобрять
missglьckt=неудачный
Missionдr=миссионер
Mississippi=Миссисипи
Misstrauen=недоверие
missverstehen=неправильно понять
Missverstдndnis=недоразумение
Mist=навоз
mit=с
mit dem Dьsenantrieb=с реактивным двигателем
mit j-m zu tun haben=иметь контакт
mit Kindersitzen=сидеть с детьми
mit Schiefer bedecken=крыть шифером
mit Wolken bedeckt=покрытый облаками
mitarbeiten=сотрудничать
Mitbesitzer=совладение
Mitgefьhl=сочувствие
Mitgift=приданое
Mitglied=член
Mitglied der Konfцder.=член конфедерации
Mitgliedschaft=членство
Mitleid=жалость
Mitnacht=полночь
Mitschьler=одноклассник
Mitspieler=товарищ по команде
Mittag=полдень
Mittagessen=обед
Mittagsmahlzeit=ленч
Mittagsruhe=полуденный отдых
Mitte=середина
Mitteilung=сообщение
mittel=средний
Mittel=средство
mittelalterlich=средневековый
Mittelfinger=средний палец
Mittelwest=Средний Запад
mittler=средний
Mittwoch=среда
Mixer=миксер
miЯgestaltet=уродливый
Mode=мода
Modell=модель
Modelpuppe=манекен
modern=современный
modernisieren=модернизировать
modifizieren=модифицировать
Mohammed=Магомет
Mohn=мак
Mohrrьbe=морковь
Mokassin=мокасин
Molekьl=молекула
Molluske=моллюск
Momentaufnahme=моментальный снимок
Monarchie=монархия
Monat=месяц
monatlich=ежемесячный
Mond=луна
Mondlicht=лунный свет
Mondmodul=лунный модуль
Mondstrahl=луч луны
Monitor=монитор
Monogramm=монограмма
Monolog=монолог
Monopolismus=монополия
Monoschiene=монорельс
monoton=монотонный
monotone Arbeit=однообразный труд
Monsun=муссон
Montag=понедельник
Moorunterland=болотная низменность
Moos=мох
Moosbeere=клюква
Moped=мопед
Moral=мораль
moralischer Zustand=моральное состояние
Mord=убийство
morgen=завтра
Morgen=утро
Morgendдmmerung=рассвет
Mosaik=мозаика
Mosambik=Мозамбик
Moschee=мечеть
Moschusochse=мускусный бык
Moslem=мусульманин
Motel=мотель
Motiv=мотив
Motor=двигатель
Motorboot=моторная лодка
Motorhaube=капот
Motorrad=мотоцикл
Motorroller=мотороллер
Motte=моль
Muff=муфта
Mulleinlage=марлевой тампон
Multiplikand=множимое
Multiplikation=умножение
Multiplikator=множитель
multiplizieren=умножать
Mund=рот
Mundart=диалект
Mundharmonika=губная гармоника
Mundstьck=мундштук
Munition=боеприпасы
murmeln=журчать
Muschel=раковина
Museum=музей
Musik=музыка
musikalisch=музыкальный
Musiker=музыкант
Muskatnuss=мускатный орех
Muskel=мускул
Muskete=мушкет
Musselin=муслин
Mustang=мустанг
Muster=образец
Mut=храбрость
mutig=мужественный
Mutter=мама
Mutterleib=матка
MuЯe=досуг
Myrte=мирт
mystisch=мифический
Mythologie=мифология
mдchtig=властный
Mдdchen=девочка
Mдdchenhaftigkeit=девичество
Mдdchenrahmen=рама для девочек
mдhen=косить
Mдher=косарь
Mдhmaschine=сенокосилка
Mдhne=грива
Mдnnchen=самец
Mдnnertreu=синеголовник
mдnnlich=мужской
Mдrtyrer=мученик
Mцbel=мебель
mцglich=возможно
Mцglichkeit=возможность
Mцglichkeit geben=давать возможность
Mцnch=монах
Mцwe=чайка
Mьcke=комар
mьde=усталый
Mьdigkeit=усталость
Mьhle=мельница
Mьhsal=тяжелый труд
Mьll=мусор
Mьlleimer=ведро для мусора
Mьllfahrer=мусорщик
Mьllhaufen=свалка
Mьllwagen=мусоровоз
mьndlich=словесный
Mьnze=монета
mьrrisch=брюзгливый
mьssen=должен
mьtterlich=материнский
Mьtze=шапка
mьЯig gehen=слоняться без дела
N=эн
Nabel=пупок
nach=после
nach auЯen=наружу
nach Belieben=как угодно
nach Hause=домой
nach innen=внутрь
nach Norden=на север
nach oben=вверх
nach Westen=к западу
nachahmen=подражать
Nachbar=сосед
Nachbarschaft=соседство
Nachbearbeitung=повторная обработка
nachdenken=размышлять
nachdenklich=задумчивый
Nachfolger=преемник
nachgeben=поддаться
nachjagen=гнаться
Nachkomme=потомок
Nachkriegs=послевоенный
nachlдssig=небрежный
Nachlдssigkeit=небрежность
Nachmittag=послеобеденное время
Nachrichten=новости
Nachschlagewerk=справочник
nachsehen=заглядывать
Nacht=ночь
Nachtgeschirr=детский горшок
Nachthemd=ночная рубашка
Nachtigal=соловей
Nachtzeit=ночная пора
nachдffen=передразнивать
nackt=обнаженный
Nadel=игла
Nadelbaum=остролистник
Nadelkissen=подушка для игл
Nadeltherapie=иглотерапия
Nagel=гвоздь
Nagelbьrste=щетка для ногтей
Nagelfeile=пилка для ногтей
Nagellack=лак для ногтей
nagelneu=с иголочки
Nagelschere=щипцы для ногтей
nagen=грызть
Nagetier=грызун
nahrhaft=питательный
Nahrung=пища
Naht=шов
namhaft=прославленный
Napf=котелок
narkotisch=наркотический
Narzisse=нарцисс
Nase=нос
Nasen=носовой
Nasenloch=ноздря
Nashorn=носорог
nass=мокрый
Nation=нация
national=национальный
Nationalismus=национализм
Nationalitдt=национальность
Natrium=натрий
Natur=природа
naturalisieren=натурализовать
Naturforscher=натуралист
natьrlich=конечно
natьrliche Umgebung=естественная среда
natьrlicherweise=естественно
Navigator=навигатор
Nebel=густой туман
nebelig=туманный
neben=рядом
Nebenbuhler=соперник
Nebenfluss=приток
Nebraska=Небраска
necken=дразнить
Neffe=племянник
Negation=отрицание
Neger=негр
nehmen=брать
neiden=завидовать
neidisch=завистливый
Neigung=склонность
nein=нет
Nektar=нектар
Nektarine=гладкий персик
Nelke=гвоздика
nennen=назвать
Nenner=знаменатель
Neon=неон
Nepal=Непал
Neptun=Нептун
Nerv=нерв
nervцs=нервный
Nerz=норка
Nest=гнездо
nett=приятный
Netz=сетка
Netzhaut=сетчатка
neu=новый
neu wдhlen=переизбрать
neuerdings=в последнее время
Neuerung=новшество
Neues Testament=Новый Завет
Neufundlдnder=ньюфаундлендец
neugeboren=новорожденный
Neuigkeit=новость
neulich=недавний
Neuling=новичок
neumodisch=новомодный
neun=девять
neunzehn=девятнадцать
neunzig=девяносто
neutral=нейтральный
Neutron=нейтронный
nicht=не
nicht einverstanden sein=не соглашаться
nicht entsprechend=несоответственный
nicht essbar=несъедобный
nicht fьr lange=ненадолго
nicht gehorsam sein=не слушаться
nicht gern haben=не любить
nicht kompetent=некомпетентный
nicht machte=не делал
nicht reinrassig=нечистокровный
nicht teuer=недорогостоящий
nicht unbedingt=необязательный
Nichte=племянница
nichtnutzig=никчемный
nichts=ничего
nicken=кивать головой
Niederlande=Нидерланды
Niederschlag=осадок
niedertrдchtig=подлый
niedrig=низкий
niemals=никогда
niemand=никто
Niere=почка
Nierenstein=почечный камень
niesen=чихать
Niete=заклепка
Nietnagel=заусеница
Nigeria=Нигерия
Nikotin=никотин
Nippel=нипель
Nippsache=безделушка
nirgends=нигде
Nische=ниша
Niveau=уровень
noch=еще
noch einmal=еще раз
nochmals lesen=перечитывать
Nomade=кочевник
nomadenhaft=кочевой
Nomination=номинация
nord-westlich=северо-западный
Norden=север
Nordlicht=северное сияние
Nordlдnder=северянин
Nordosten=северо-восток
Nordwest=северо-запад
nordwдrts=северное направление
normal=нормальный
norwegisch=норвежский
Notausgang=аварийный выход
Note=нота
Notizbuch=записная книжка
Notizen=заметки
Notwendigkeit=необходимость
Novacho=навахо
November=ноябрь
Nudeln=лапша
nuklearer Regen=радиоактивные осадки
Null=нуль
Nummernschild=номерной знак
nur=только
Nutzen=польза
Nylon=нейлон
Nymphe=нимфа
nдchtlich=ночной
Nдherin=швея
Nдhmaschine=швейная машинка
Nдhrstoff=питательное вещество
nдmlich=а именно
nцrdlich=к северу
nцtig=необходимый
nцtigen=принуждать
nьchtern=трезвый
nьtzlich=полезный
Nьtzlichkeit=полезность
O=о
Oase=оазис
ob=ли
Obdach=убежище
obdachlos=бездомный
oben=наверху
Ober=верхний
Oberarm=плечевая часть
oberer Schlag=верхний удар
Oberflдche=поверхность
Oberkleider=верхняя одежда
Oberlichtflьgel=фрамуга
Oberst=полковник
oberste=самый верхний
Objektiv=объектив
Obligation=облигация
obligatorisch=обязательный
Oboe=гобой
Obstgarten=фруктовый сад
obwohl=хотя
Ochse=бык
Ochsen=быки
Ochsenfrosch=лягушка-бык
offen=открытый
offenbar=очевидно
Offenheit=гласность
offenherzig=искренний
offerieren=предлагать
offiziell=официальный
Offset=офсет
oft=часто
oh!=ай!
ohne=без
ohne Energie sein=лишаться энергии
ohne Privilegium=лишенный привилегий
ohne Sattel=без седла
Ohnmacht=обморок
Ohr=ухо
Ohrenklappen=наушники
Ohrgehдnge=серьги
Ohrklipps=клипсы
Ohrring=серьга
Ohrschmerz=боль в ухе
Oktave=октава
Oktober=октябрь
Olive=маслина
Olympische Spiele=Олимпийские игры
Onkel=дядя
Ontario-See=озеро Онтарио
Opal=опал
Oper=опера
Operateur=оператор
Operette=оперетта
Opfer=жертва
Opponent=оппонент
Opposition=противодействие
optimistisch=оптимистичный
optisch=оптический
Orang-Utan=орангутанг
Orange=апельсин
Orangeade=оранжад
Orbit=орбита
Orchester=оркестр
Orchidee=орхидея
ordentlich=должным образом
ordnungsgemдЯ=в должном порядке
Ordnungszahl=порядковое числительное
Oregon=Орегон
Organisation=организация
organisch=органический
organisieren=организовать
Organismus=организм
Orgel=орган
Orientierung=ориентир
Original=подлинный
Orkan=ураган
Orthodontist=ортодонтист
orthodox=православный
Osten=восток
Ostern=пасха
Otter=гадюка обыкновенная
Ouverture=увертюра
Oval=овал
Oxford=Оксфорд
Oxyd=окись
oxydieren=окислять
Ozean=океан
Ozeandampfer=океанский лайнер
Ozelot=оцелот
Ozon=озон
P=пэ
Paar=пара
Pacht=аренда
Pachtgeld=арендная плата
packen=укладывать
Packkorb=упаковочная клеть
Packpapier=оберточная бумага
Paddel=весло
paffen=дымить
Paket=сверток
Pakistan=Пакистан
Pala Antilope=антилопа пала
Palast=дворец
Palette=палитра
Palme=пальма
Palmenblatt=лист пальмы
Palmette=пальметто
Palдstina=Палестина
Pamphlet=памфлет
Panel=панель
Panik=паника
Panorama=панорама
Panther=пантера
Pantoffeln=комнатные туфли
Pantomime=пантомима
Panzer=танк
Papa=папа
Papagei=попугай
Papaya=папайя
Papier=бумага
Papierhut=бумажная шляпа
Papierkorb=корзина для бумаги
Papierpaket=бумажный пакет
Papiertьcher=бумажные полотенца
Papierumschlag=бумажная обертка
Pappel=тополь
Paprika=перец стручковый
Papst=папа римский
Papyrus=папирус
Paradies=рай
Paraffin=парафин
Paragierdampfer=лайнер
Paragraph=параграф
Paraguay=Парагвай
Parallele=параллель
parallele Linie=параллельные линии
Parallelogramm=параллелограмм
Paralyse=паралич
Paranuss=орех калифорнийский
Park=парк
Parka=парка	тёплая удлинённая (до колен) спортивная куртка с капюшоном
Parka m=парка
Parken=стоянка
Parkplatz=стоянка автомашин
Parkplatzzдhler=стояночный счетчик
Parkweg=парковая дорога
Parlament=парламент
Parodie=пародия
Parole=пароль
Partei=партия
Parterreplдtze=места в партере
Partisan=партизан
Partizip=причастие
Partner=партнер
Partnerschaft=партнерство
Pass=паспорт
Passagier=пассажир
Passagierdampfer=лайнер
passend=подходящий
Paste=паста
Pastell=пастель
Pate=крестный отец
Patent=патент
Patin=крестная мать
Patriarch=патриарх
Patriotismus=патриотизм
Patrone=патрон
Pauke=литавра
Pause=антракт
Pavian=павиан
Pech=неудача
Pech haben=потерпеть неудачу
Pedal=педаль
Peitsche=кнут
Pelikan=пеликан
Pelz=мех
Pelzmantel=шуба
Pelzmьtze=меховая шапка
Pelzьberhang=меховая накидка
Pendel=маятник
Penizillin=пенициллин
Pensilwanien=Пенсильвания
Pentagon=Пентагон
per Anhalter=автостопом
Pergament=пергамент
Perimeter=периметр
Periode=период
periodisch=периодический
periodische Ausgabe=периодическое издание
Peripherie=окраины
Periskop=перископ
Perle=жемчуг
persisch=персидский
Person=личность
Personal=персонал
Personalbestand=личный состав
Personenauto=легковая автомашина
perspektivisch=перспективный
persцnlich=личный
Peru=Перу
Perьcke=парик
Peso=песо
pessimistisch=пессимистический
Petersilie=петрушка
Petritдsschen=чашечка Петри
Petroleum=керосин
Petunie=петуния
Pfad=тропа
Pfahlzaun=частокол
Pfand=залог
Pfanne=сковорода
Pfannkuchen=блин
Pfarr=приходский
Pfau=павлин
Pfeffer=перец
Pfefferbьchse=перечница
Pfefferminze=мята перечная
Pfeife=курительная трубка
pfeifen=свистеть
Pfeil=стрела
Pfeilspitze=острие стрелы
Pfennig=феннинг
Pferd=лошадь
Pferdestдrke=лошадиная сила
Pfiff=свист
Pfingstrose=пион
Pfirsich=персик
Pflanze=растение
pflanzen=сажать
Pflanzen=посадка
Pflanzenblattlaus=тля растительная
Pflanzenkrankheit=болезнь растений
Pflanzenleim=растительный клей
Pflaster=мостовая
Pflastern=мощение
Pflaume=слива
Pflicht=долг
Pflicht erweisen=отдавать долг
Pflock=колышек
Pflug=плуг
pflьgbar=пахотный
pflьgen=пахать
Pfote=лапа
Pfropfen=пробка
Pfropfreis=привой
Pfund Sterling=фунт стерлингов
Phantasie=фантазия
phantasieren=фантазировать
phantastisch=фантастический
Phantom=фантом
Phantomstadt=город-призрак
Pharao=фараон
Phase=фаза
Philantrop=филантроп
Philodendron=филодендрон
Philosoph=философ
Philosophie=философия
Phlox=флокс
phonetisch=фонетический
Phonograph=фонограф
Phosphor=фосфор
Photoapparat=фотоаппарат
Photograph=фотограф
Photokopierer=фотокопировальный автомат
Photokopietisch=столик фотокопира
Photosynthese=фотосинтез
Phrase=фраза
Physik=физика
Physiker=физик
physisch=физический
Phдnomen=феномен
Pianist=пианист
Pickel=прыщ
picken=клевать
Picknick=пикник
Picknicktisch=столик для пикника
Picksel=пиксел
Piedestal=пьедестал
piepsen=пищать
Pigment=пигмент
Pike=пика
Pikkolo=пикколо
Piknikkorb=корзина продуктов
Pilger=паломник
Pille=пилюля
Pilot=летчик
Pilze=грибы
Pingpong=пинг-понг
Pingpongball=теннисный шарик
Pinguin=пингвин
Pinsel=кисточка
Pint=пинта
Pinzette=пинцет
Pionier=пионер
Pistazie=фисташковое дерево
Pistole=пистолет
Pizza=пицца
Plaid=плед
Plakat=плакат
Plan=план
Planet=планета
Planetarium=планетарий
Plankton=планктон
Planwagen=фургон
Plasma=плазма
plastisch=пластичный
Plateau=плато
Platin=платина
platt=тривиальный
Plattenspieler=проигрыватель
Platz neben dem Bett=место у кровати
Platzanweiser=билетер
Plekton=медиатор
plump=неповоротливый
Plural=множественное число
Pluton=Плутон
Plutonium=плутоний
plдdieren=выступать в суде
Plдtschern=всплеск
Plцtze=плотва
plцtzlich=внезапно
plцtzlicher Beginn=внезапное начало
Pocken=оспа
Podium=помост
Poesie=поэзия
poetisch=поэтический
polar=полярный
Polemik=полемика
Polen=Польша
polieren=наводить лоск
Polio=полиомиелит
Politik=политика
Politiker=политик
Polizei=милиция
Polizeiabteilung=отделение полиции
Polizeistunde=комендантский час
Polizist=полицейский
Polizistin=женщина-полицейский
Polka=танец полька
Polo=поло
Polohemd=тенниска
Polstern=набивка
poltern=грохотать
Polyp=полип
Pommes frites=картофель фри
Pomp=помпа
Poncho=пончо
Pony=пони
Popcorn=попкорн
Popularitдt=популярность
porig=пористый
Porree=лук-порей
Portemannaie=кошелек
Portier=швейцар
Portikus=портик
Portrдt=портрет
portrдtieren=писать портрет
Portugal=Португалия
portugiesisch=португальский
Porzellan=фарфор
Posaune=тромбон
Positionslampe=габаритный фонарь
positiv=положительный
possessiv=притяжательный
Post=почтовый
Postamt=почтамт
Postangestellte=почтовый служащий
Postauto=почтовая машина
Postkarte=почтовая карточка
Postkutsche=дилижанс
Poststempel=почтовый штемпель
potential=потенциальный
Pracht=великолепие
Prachtwohnung=роскошная квартира
prahlen=хвастаться
praktisch=практически
Praxis=практика
predigen=читать проповедь
Prediger=проповедник
Predigt=проповедь
Preis=приз
preisen=восхвалять
Prellstein=тумба
Presse=пресса
Primat=примат
Primel=первоцвет
Prinz=принц
Prinzessin=принцесса
Prinzip=принцип
Prisma=призма
Prister=священник
privat=частный
Privatflugzeug=личный самолет
Privatlehrer=домашний учитель
privilegiert=привилегированный
pro=за
pro Stьck=за штуку
Probe=попытка
proben=репетировать
Probierglдschen=пробирка
Problem=проблема
Produkt=продукт
Produktion=производство
Produzent=продюсер
professionell=профессиональный
Professor=профессор
Profil=профиль
Prognose=прогноз
Programm=программа
Programmierer=программист
progressiv=прогрессивный
Projecktor=проектор
Projekt=проект
Projektion=проекция
Pronomen=местоимение
Propaganda=пропаганда
Propeller=пропеллер
Propellerflugzeug=винтовой самолет
Propellerschlitten=аэросани
propfen=прививать
Propfen=затычка
Prophet=предсказатель
Proportion=пропорция
Prosa=проза
Protestant=протестант
protestieren=протестовать
Proton=протон
Protoplasma=протоплазма
Protozoen=простейшие животные
Provinz=провинция
provinziell=провинциальный
Provision=провизия
provozieren=провоцировать
Prozent=процент
Prozentual=процентное содержание
Prozess=процесс
prozessieren=возбуждать дело
ProzeЯ=процесс
prдchtig=великолепный
Prдdikat=предикат
Prдfix=префикс
prдpositional=предложный
Prдrie=прерия
Prдsident=президент
Prдsidentin=председательница
Prдsidentschaft=президентство
Prдzendenzfall=прецедент
prьfen=экзаменовать
Prьfung=экзамен
Prьgel=побои
Psalm=псалом
Psychologe=психолог
Psychologie=психология
psychologisch=психологический
Publikation=публикация
Publikum=публика
Pudding=пудинг
Pudel=пудель
Pueblo=пуэбло
Pullover=свитер
Pullover mit Ausschnitt=свитер с вырезом
Puls=пульс
Pulver=порошок
Puma=пума
Pumpe=насос
Punkt=точка
Punktion=пункция
Pupille=зрачок
Puppe=кукла
Puppenhaus=кукольный домик
Puritaner=пуританин
purpur=пурпурный
putzen=чистить
Pyramide=пирамида
Python=питон
Pдckchen=пачка
pьnktlich=пунктуальный
Q=ку
Quadrat=квадрат
Quaken=кваканье
Qual=страдание
Qualifikation=квалификация
qualifizieren=квалифицировать
Qualitдt=качество
Quantitдt=количество
Quarantдne=карантин
Quark=творог
Quart=кварта
Quartett=квартет
Quarz=кварц
Quecke=пырей
Quelle=исток
quellen=размачивать
quer=поперек
Quetzal=кетцаль (птица)
quirlen=смешивать
Quittung=квитанция
Quote=квота
Quдker=квакер
R=эр
Rabbi=раввин
Rabe=ворон
Rabennest=воронье гнездо
Rache=мщение
rachitisch=рахитичный
Rad=колесо
Radar=радар
Radiergummi=ластик
Radierung=офорт
Radieschen=редиска
radikal=радикальный
Radio=радио
radioaktiv=радиоактивный
Radius=радиус
Radon=радон
Raffinerie=рафинадный завод
Rahmen=рама
Rakete=ракета
Raketenschlag=ракетный удар
Rampenlicht=огни рампы
Ranch=ранчо
Rand=край
Rang=ярус
Rasen=газон
rasend=неистовый
Rasenmдher=газонокосилка
Raserei=бешенство
rasieren=брить
Rasierklinge=лезвие для бритвы
Rasiermesser=бритва
Rasse=раса
Rassen=расовый
rassig=породистый
Rast=отдых, привал
Rat=совет
raten=советовать
ratifizieren=ратифицировать
Ratte=крыса
Raub=грабеж
rauben=грабить
Raubtier=хищник
Rauch=дым
rauchend=дымный
Rauchfang=дымоход
rauh=шершавый
Raum=помещение
Raumanzug=скафандр
Raumschiff=космический корабль
Raupe=гусеница
rauschen=шелестеть
reagieren=реагировать
Reaktion=реакция
reaktiv=реактивный
Reaktor=реактор
realistische=реалистичный
Rebell=повстанец
Rebhuhn=куропатка
Rebstock=виноградная лоза
Rechen=грабли
Rechenfehler=просчет
rechnen=считать, вычислять
recht=правый
rechte Winkel=прямой угол
Rechteck=прямоугольник
Rechtsanwalt=адвокат
Rechtsbahn=правая полоса
Rechtschreibung=правописание
rechtshдndig=правосторонний
Rechtsprechung=правосудие
Rechtsverletzung=посягательство
rechtwinklige Dreiecke=прямоугольный треугольник
Redakteur=редактор
redaktieren=редактировать
Redaktion=редакторский
Rede=речь
redegewandt=красноречивый
Referent=референт
reformieren=реформировать
Regal=полка
regelmдЯig=регулярный
regelmдЯige=закономерный
regeln=регулировать
Regen=дождь
Regenbogen=радуга
Regenguss=ливень
Regenpfeifer=зуек
Regenschirm=зонтик
Regentropfen=капля дождя
regieren=управлять
Regierung=царствование
Regime=режим
Regiment=полк
Registrator=регистратор
registrieren=регистрировать
Registrierung=регистрация
regnerisch=дождливый
regulieren=регулировать
Regulierung=регулирование
Reh=косуля
reiben=тереть
Reibung=трение
Reich=государство, империя
reich sein=быть богатым
reichlich=изобильный
Reichs=имперский
Reichtum=богатство
reif=зрелый
Reife=зрелость
Reifen=обруч
Reihenfolge=последовательность
Reiher=цапля
Reim=рифма
rein=непорочный
reinigend=очищающий
Reiniger=очиститель
Reinigkeit=чистота
Reinigung=очистка
reinlich=чистоплотный
Reinlichkeit=чистота
Reis=рис
Reise=путешествие
Reisedecke=плед
reisen=путешествовать
Reisende=путешественник
Reiseschuhe=туристские ботинки
Reiseverkehrskaufmann=агент по туризму
reiten=ехать верхом
Reiter=наездник
Reiterei=кавалерия
Reiterin=всадница
reizen=раздражать
reizend=прелестный
reiЯen=рвать
reiЯender Strom=стремительный поток
ReiЯverschluss=застежка-молния
Religion=религия
religiцs=религиозный
Rennbahn=трек
Rennsteuer=гоночный руль
Rente=пенсия
Rentier=северный олень
Reparaturarbeiter=ремонтник
reparieren=ремонтировать
Reporter=репортер
Republik=республика
Reseiwer=ресивер
Reservation=резервирование
Reservebremse=запасной тормоз
Reservegleis=запасный путь
reservierend=бронированный
Reservierung=броня
Rest=остаток
Restaurant=ресторан
restaurieren=реставрировать
Reste=остатки
Restzeit=сверхурочное время
Resьmee=краткое изложение
Retrorakete=ретроракета
retten=спасать
Retter=спасатель
Rettung=спасение
Rettungsboot=спасательная шлюпка
Rettungsgьrtel=спасательный пояс
Revolver=револьвер
Rezept=рецепт
Rezidiv=рецидив
Rhabarber=ревень
rheumatisch=ревматический
Rheumatismus=ревматизм
Rhododendron=рододендрон
Rhombus=ромб
Rhythmus=ритм
Richter=судья
richtig=правильный
Richtung=направление
riechen=нюхать
Riegel=задвижка
Riemen=ремень
Riese=великан
Riesenrad=чертово колесо
riesig=громадный
Riff=риф
Rind=крупный рогатый скот
Rinde=кора
Rinderhirtin=девушка-ковбой
Rindfleisch=говядина
Rindssьlze=говяжий студень
Ring=кольцо
Ringe fьr Vorhang=кольца для занавеси
Ringelblume=ноготки
Ringfinger=безымянный палец
ringsherum=кругом
Rinne=желоб
Rippe=ребро
Risiko=риск
riskant=рискованный
Riss=разрыв
Rist=подъем стопы
Ritter=рыцарь
Ritterschaft=рыцарство
rittlings=верхом
Ritual=ритуал
rivalisieren=соперничать
Rochen=скат
Rock=юбка
Rock and Roll=рок-н-рол
Roggen=рожь
Rohr=труба
Rohrkolben=рогоз
Rohrleitung=трубопровод
Rohseide=шелк-сырец
Rollbahn=стартовая дорожка
Rolle=рулон
Rollkragenpullover=водолазка
Rollschuh fahren=кататься на роликах
Rollstein=валун
Rollstuhl=инвалидная коляска
Rolltreppe=эскалатор
Rolodex=ролодэкс
Roman=роман
Romanist=романист
romantisch=романтический
Rose=роза
Rosenknospe=бутон розы
Rosenkohl=капуста брюссельская
Rosine=изюм
Rosinen=изюм
Rost=ржавчина
rosten=ржаветь
rostig=ржавый
rot=красный
Rote Ecke=красный уголок
rote Johannisbeere=красная смородина
rotglьhend werden=накаляться докрасна
Rotholz=красное дерево
Rotkehlchen=малиновка
rotwangig=румяный
Routine=подпрограмма
Rowdy=хулиган
Rubel=рубль
Rubin=рубин
Ruck=рывок
ruckartig ziehen=дергать
Rucksack=рюкзак
Ruder=весло
Ruderboot=гребная шлюпка
Ruderpinne=румпель
Ruf=репутация
Ruhe=тишина
Ruhestцrer=нарушитель порядка
ruhig=спокойный
Ruinen=руины
Rum=ром
Rumpf=фюзеляж
rund=круглый
Rundbьrste=ершик
rundes Gebдck=пончик
Rundfahrt=объезд
Rundschreiben=циркуляр
runzelig=сморщенный
russisch=русский
Rutschbahn=детская горка
RuЯ=копоть
Rдtsel=загадка
Rдuber=разбойник
rцcheln=хрипеть
rцhmischer Typus=римский тип
rцmisch=римский
Rцntgenstrahlen=рентгеновские лучи
rцsten=жарить
Rцstofen=сжигательная печь
Rьbe=репа
Rьckadresse=обратный адрес
Rьcken=тыл
Rьckenschmerz=боль в спине
Rьckhalt=резерв
Rьcklicht=задний свет
Rьckscheinwerfer=задние фонари
Rьckspiegel=зеркало заднего вида
Rьckzug=отступление
Rьckzugssignal=отбой
rьhrend=трогательный
Rьssel=хобот
Rьsselkдfer=долгоносик
S=эс
Saal=зал, вестибюль
Sache=дело
Sachverstдndiger=эксперт
Sack=мешок
sackartig=мешковатый
Sackleinen=мешковина
Safari=сафари
Saft=сок
saftig=сочный
sagen=сказать
sagenhaft=легендарный
Sahne=сливочный
Sahnebonbon=ириска
Sahneeis mit Zuckersaft=пломбир с сиропом
Sahnekanne=сливочница
Saite=струна
Salamander=саламандра
Salat=салат
Salat mit Wьrze=салат с приправами
Salatschьssel=салатница
Salbe=мазь
Salto=сальто
Salto machen=делать сальто
Salut=салют
Salz=осадок
Salzfass=солонка
salzig=соленый
Salzlake=рассол
Samenkapsel=семенная коробочка
sammeln=собирать
Sammlung=собрание
Samstag=суббота
Samt=бархат
Sand=песок
Sandale=сандалия
Sanddьne=песчаная дюна
sandig=песчаный
Sandkasten=ящик с песком
Sandpapier=наждачная бумага
Sandrohr=песчаная труба
Sandschloss=песчаный замок
Sandstein=песчаник
Sanduhr=песочные часы
Sanitдtsarbeiter=мусорщик
Saphir=сапфир
Sardelle=анчоус
Sardine=сардина
Sarg=гроб
Sattel=седло
Saturn=Сатурн
Satzung=устав
Satzzeichen=знак препинания
sauber=чистый
Sauberkeit=опрятность
sauer=кислый
Sauerklee=кислица
Sauerstoff=кислород
saugen=сосать
Saugerьssel=хоботок
Saum=кайма
Saxophon=саксофон
schaben=скрести
Schablone=шаблон
Schach=шахматы
Schachbrett=шахматная доска
Schachtel=коробка
Schaf=овца
Schaffel=овчина
Schaffner=кондуктор
Schaffung=создание
Schaft=патрон
Schakal=шакал
Schal=шарф
Schale=кожура
Schallplatte=пластинка
schallundurchlдssig=звуконепроницаемый
Schalter=выключатель
Schaltpult=распределительный щит
Schaltung=переключатель передач
Scham=стыд
Schampoo=шампунь
Schamrцte=румяна
scharf=острый
scharfer Ton=резкий звук
scharfsinnig=остроумный
Schattierung=оттенок
Schatz=сокровище
Schatzkammer=сокровищница
Schaubild=диаграмма
schaudern=вздрагивать
Schaufel=лопата
Schaufelrad=гребное колесо
Schaukel=качели
schaukeln=качаться
Schaukeln=раскачивание
Schaukelstuhl=кресло-качалка
Schaum=пена
Schauspieler=актер
Schauspielerin=актриса
Scheibe=стекло
Scheibenwischer=стеклоочиститель
Scheich=шейх
Scheide=ножны
Scheidung=развод
scheinen=казаться
Scheinwerfer=прожектор
Scheitel=пробор
Scheitelpunkt=вершина
Schellack=шеллак
Schelmerei=шалость
schematisch=схематичный
schenken=дарить
Schere=ножницы
Scheriff=шериф
scherzen=шутить
scheu=боязливый
Scheuerlappen=половая тряпка
scheuЯlich=отвратительный
Schicht=слой
Schicksal=рок
Schieber=подкладное судно
Schiedsrichter=рефери
Schiedsspruch=третейский суд
schief=кривобокий
Schiegervater=тесть
schielen=косить глазами
schienen=накладывать шину
schieЯen=стрелять
SchieЯpulver=порох
Schiff=корабль
Schiffahrt=судоходство
Schiffbruch=кораблекрушение
Schiffsbauhalle=эллинг
Schiffsreise=морское путешествие
Schihut=лыжная шапочка
schikanieren=придираться
Schild=щит
Schildkrцte=черепаха
Schilf=камыш
Schilling=шиллинг
Schimmel=плесень
Schimpanse=шимпанзе
Schimpf=бесчестье
Schinken=ветчина
Schirm=экран
Schirmdach=навес
Schirmmьtze=головной убор
Schlacht=сражение
Schlachtschiff=линейный корабль
Schlafanzug=пижама
schlafen=спать
schlafende=спящий
Schlafmьtze=соня
Schlafsack=спальный мешок
Schlafsessel=кресло-раскладушка
schlaftrunken=сонный
Schlafzeit=время сна
Schlafzimmer=спальня
schlagen=взбивать
Schlagen=биение
Schlagzeuger=барабанщик
Schlamm=слякоть
schlammig=илистый
Schlange=змея
schlank=стройный
schlau=хитрый
Schlauch=трубка акваланга
Schlauchboot=надувная лодка
SchlauchfloЯ=надувной плот
schlecht=плохо
schlecht umgehen=плохо обращаться
Schleier=вуаль
Schleifbock=шлифовальная бабка
Schleifmaschine=шлифовальная машина
Schleim=слизь
schleppen=тащить, таскать, волочить
Schlepper=буксир, тягач
Schleppkahn=баржа
Schleppnetz=невод
Schleuder=рогатка
schleudern=швырять
Schleuse=шлюз
schlieЯen=закрывать
schlimme Vorahnung=дурное предчувствие
Schlinge=петля
Schlitten=санки
Schlittschuh=конек
Schloss=замок
Schlossmacher=мастер по замкам
Schlucht=каньон
schluchzen=рыдать
Schluck=глоток
Schluckauf=икота
schlucken=пить маленькими глотками
schlummern=вздремнуть
Schluppe=шлюп
schlurfen=шаркать ногами
Schluss=окончание
Schlussfolgerung=заключение
SchluЯlicht=катафот
schlьrfen=шлепать
Schlьssel=ключ
Schlьsselbein=ключица
Schlьsselloch=замочная скважина
schmackhaft=приятный на вкус
schmatzen=чавкать
schmeicheln=льстить
Schmeichler=подлиза
schmelzen=таять
Schmerz=боль
schmerzlos=безболезненный
Schmetterling=бабочка
Schmied=кузнец
Schmiedebalg=кузнечные мехи
schmieren=смазывать
Schmirgel=наждак
Schmiss=шрам
schmollen=дуться
Schmuck=украшение
Schmuckwaren=ювелирные изделия
Schmutz=грязь
schmutzig=грязный
schmьcken=приукрашивать
Schnabel=клюв
Schnabeltier=утконос
Schnake=мошка
schnalzen=щелкать
schnarren=скрипеть
schnauben=фыркать
Schnaufen=сопение
Schnauze=носик
Schnecke=улитка
Schnee=снег
Schneeball=снежок
Schneeflocke=снежинка
Schneemann=снеговик
Schneerдumer=снегоочиститель
Schneeschuh=лыжа
Schneeschuhe=снегоступы
Schneesturm=снежная буря
Schneide=острие
schneiden=резать
Schneider=портной
schnell=быстрый
schnell vergehen=лететь (о времени)
Schnepfe=бекас
Schnitte=ломоть
Schnittholz=пиломатериал
Schnittmuster=выкройка
schnitzen=строгать ножом
Schnuller=соска пустышка
Schnur=шнурок
Schnurrbart=усы
schnurren=мурлыкать
schnьren=заворачивать
Schokolade=шоколад
schon=уже
schon nicht=уже не
Schoner=шхуна
Schorf=струп
schorfig=покрытый струпьями
Schornstein=дымоход
Schotenbohne=стручковая фасоль
Schotte=шотландец
schottisch=шотландский
Schramme=шрам
Schrank=шкаф
Schraube=винт
Schraubenmutter=гайка
Schraubenzieher=отвертка
Schraubstock=тиски
Schreck=испуг
schrecklich=ужасный
schreiben=писать
Schreibmappe=папка для бумаг
Schreibmaschine=пишущая машинка
Schreibtischstuhl=кресло машинистки
schreien=вопить
Schrein=сундук
schreiten=шагать
schrie=кричал
schriftkundig=грамотно
schriftlich=письменный
Schriftsteller=писатель
schrill schreien=пронзительно кричать
Schritt=шаг
schrubben=мыть щеткой
schrдge Flдche=наклонная плоскость
Schubfach=выдвижной ящик
Schubkarren=тачка
Schuft=негодяй
Schuh=ботинок
Schuhband=шнурок для ботинок
Schuhsohle=подошва
Schuld=вина
schuldig=виновный, виноватый
Schuldigkeit=виновность
Schuldner=дебитор
Schule=школа
Schulgebдude=здание школы
Schulter=плечо
Schulterband=перевязь
schuppig=чешуйчатый
Schuss=выстрел
Schusswaffen=огнестрельное оружие
Schuttabladeplatz=свалка
Schutz=охрана
Schutzbrille=защитные очки
Schutzdach=навес
Schutzjacke=защитная куртка
Schutzmarke=фабричная марка
Schutzmaske=защитная маска
Schutzschirm=защитный экран
schwach=слабый
Schwadron=эскадрон
Schwalbe=городская ласточка
Schwan=лебедь
schwanger=беременная
schwankend=колеблющийся
Schwanz=хвост
Schwanzpagagei=длиннохвостый попугай
Schwarm=стая
schwarz=черный
Schwarzbohne=черная фасоль
schwarze Johannisbeere=черная смородина
Schwarzfahrer="заяц"
schwatzen=болтать
schweben=свободный полет
schwedisch=шведский
Schwefel=сера
schweigsam=молчаливый
Schwein=свинья
Schweinefleisch=свинина
Schweinestall=свинарник
schweizerisch=швейцарский
Schwelle=порог
schwer=тяжелый
schwer atmen=дышать с трудом
Schwere=тяжесть
schwerelos=невесомый
schwerfдllig gehen=идти грузно
Schwerkraft=тяготение
schwermьtig=тоскливый
Schwert=меч
Schwertfisch=меч-рыба
Schwester=сестра
Schwesternverhдltnisse=отношения сестер
Schwiegersohn=зять
Schwiegertochter=невестка
schwierig=трудный
Schwierigkeit=трудность
Schwimmbrett=плавательная доска
schwimmen=плавать
Schwimmer=пловец
Schwimmweste=спасательный жилет
Schwindelei=вранье
schwindelig=головокружительный
schwingen=размахивать
Schwingung=колебание
schwitzen=потеть
Schwund=исчезновение
Schwung=размах
Schwur=клятва
schwдrmen=кишеть
schwцren=клясться
schwьl=душный
Schдdel=череп
schдdlich=вредный
schдdliches Insekt=вредное насекомое
Schдferhund=овчарка
schдlen=очищать
schдrfen=заострять
Schдtzung=оценка
schцn=хороший
Schцnheit=красота
Schцpfer=создатель
schцpferisch=творческий
Schцpfkelle=черпак
Schьler=ученик
Schьrsenkel=кочерга
Schьrze=фартук
Schьssel=миска
Schьttelfrost=озноб
schьtteln=трясти
Schьtze=стрелок
schьtzen=защищать
sechs=шесть
sechzehn=шестнадцать
sechzig=шестьдесят
sedimentдr=осадочный
See=озеро
Seehund=тюлень
Seeigel=морской еж
Seekrankmachen=укачиваемый на море
Seekuh=ламантин
Seele=душа
Seemann=моряк
Seepferdchen=морской конек
Seerдuber=пират
Seerдuberei=пиратство
Seestern=морская звезда
Segel=парус
Segelboot=парусная лодка
Segelflugzeug=дельтаплан
Segeltuch=парусина
Segen=благословение
segnen=благословлять
Seh=зрительный
Sehne=сухожилие
sehr=весьма
sehr hoch=очень высокий
sehr schnell laufen=бежать стремглав
seicht=мелководный
Seide=шелк
seidenartig=шелковистый
Seidenraupe=шелковичный червь
Seife=мыло
Seifenschale=мыльница
Seifenschaum=мыльная пена
sein=его
Seismograph=сейсмограф
seitdem=с тех пор как
Seite=страница
Seiten=боковой
Seitenlinie=боковая линия
Seitenspiegel=боковое зеркало
seitlich=сбоку
Sekretдr=секретарь
Sekte=секта
Sektion=секция
selbst=сам
Selbstbeherschung=самообладание
selbstgefдllig=самодовольный
selbstgemacht=самодельный
Selbstmord=самоубийство
selbstvertrauend=самоуверенный
selbstzufrieden=самодовольный
Seligkeit=блаженство
Sellerie=сельдерей
selten=редко
Seltsamkeit=странность
Semester=семестр
Semikolon=точка с запятой
Senat=сенат
Senator=сенатор
senden=посылать
Sender=передатчик
Sendung=передача
Senf=горчица
senken=опускать
senkrecht=вертикально
Senkrechte=перпендикуляр
Senkung=снижение
Senor=сеньор
Sensation=сенсация
sensationell=сенсационный
sentimental=сентиментальный
Seppelhose=штаны ковбоев
September=сентябрь
Sequoie=секвойя
Serie=серия
Serien=серийный
Serum=сыворотка
Serviette=салфеточка
Sessel=кресло
Setter=сеттер
Setzlinge=рассада
seufzen=тяжело вздыхать
siamesische Katze=сиамская кошка
sich=себя
sich anhдufen=скопляться
sich anschlieЯen=примыкать
sich anstellen=притворяться
sich aufhalten=задерживаться
sich ausstrecken=растянуться
sich ausziehen=раздеваться
sich beeilen=торопиться
sich begnьgen=довольствоваться
sich bemьhen=прилагать усилия
sich benehmen=вести себя
sich berufen=ссылаться
sich beschдftigen=заниматься
sich beugen=склоняться
sich beunruhigen=беспокоиться
sich beziehen=ссылаться
sich biegen=изгибаться
sich brьsten=гордиться
sich bдumen=становиться на дыбы
sich ducken=пригибаться
sich einmischen=вмешиваться
sich enthalten=воздерживаться
sich entrьsten=негодовать
sich entschuldigen=извиняться
sich entsetzen=ужасать
sich entspannen=расслабляться
sich entzьnden=воспламеняться
sich ergeben=посвящать
sich erheben=подниматься
sich erinnern=вспоминать
sich freuen=радоваться
sich halten=придерживаться
sich herumstoЯen=толкаться
sich hinausstrecken=высовываться
sich hьten=остерегаться
sich in FaltenLegen=морщиться
sich irren=ошибаться
sich konzentrieren=концентрироваться
sich krдuseln=завиваться
sich krьmmen=корчиться
sich lehnen=прислоняться
sich lцsen=растворяться
sich schaukeln=раскачиваться
sich schlecht benehmen=дурно вести себя
sich schleichen=красться
sich schlдngeln=извиваться
sich senken=оседать
sich setzen=садиться
sich sonnen=загорать
sich spezialisieren=специализироваться
sich streiten=браниться
sich strдuben=ощетиниться
sich trьben=тускнеть
sich unterscheiden=разниться
sich unterwerfen=подчиняться
sich verbrennen=обжигаться
sich vereinigen=объединяться
sich verirren=заблудиться
sich verlassen=полагаться
sich vermehren=размножаться
sich verschlechtern=ухудшаться
sich versprechen=сговариваться
sich verstecken=прятаться
sich verstдrken=укрепляться
sich vorstellen=представлять себе
sich wenden=поворачиваться
sich wenden an=обращаться
sich werfen=набрасываться
sich wiegen=качаться
sich winden=извиваться
sich wдrmen=греться
sich zerstreuen=рассеиваться
Sichel=серп
sicher=уверенный
Sicherheit=безопасность
sichtbar=видимый
Sichtbarkeit=видимость
sickern=сочиться
sie=она
Sie=вы
Sieb=решето
sieben=семь
siebzehn=семнадцать
siebzig=семьдесят
Siedler=поселенец
Siedlung=колония
Sieg=победа
siegen=побеждать
siegreich=победоносный
Signal=сигнал
Signallampe=сигнальная лампа
Silbe=слог
Silber=серебро
Silberschmied=мастер своего дела
Silizium=кремний
Silo=силос
Sims=карниз
singen=петь
Singular=единственное число
Singvцgel=певчая птица
Sinn=чувство
Siphon=сифон
Sirene=клаксон
Situation=ситуация
Sitz=сиденье
sitzen=сидеть
Sitzung=заседание
Skalp=скальп
Skalpellsatz=набор скальпелей
skeptisch=скептический
Sketch=скетч
Skilдufer=лыжник
Sklaverei=кабала
sklawisch=по рабски
Skorpion=скорпион
Skunk=скунс
Skunks=скунс
Slang=сленг
Smaragd=изумруд
Smog=смог
Snob=сноб
Socke=носок
Soda=сода
Sofa=диван
sofort=немедленно
Softball=софтбол
sogar=даже
Sohle=подметка
Sohn=сын
Soja=соя
solch ein=такой
Soldat=солдат
Solist=солист
Solo=соло
Sologitarist=соло-гитарист
Sombrero=сомбреро
Sommer=лето
Sommerestrade=летняя эстрада
Sommersprosse=веснушка
Sonargerдt=гидролокатор
Sonde=зонд
sonderbar=странный
Sonne=солнце
Sonnenaufgang=восход солнца
Sonnenblume=подсолнечник
Sonnenbrille=солнечные очки
Sonnenbrдune=загар
sonnengebrдunt=загорелый
Sonnenlicht=солнечный свет
Sonnenschutzmittel=лосьон для загара
Sonnenuhr=солнечные часы
sonnig=солнечный
Sonntag=воскресенье
Sorbet=шербет
Sorge=забота
sorgfдltig=тщательный
sorglos=беспечный
Sorte=сорт
SOS=СОС
Souverдn=суверенный
sozial=социальный
Sozialismus=социализм
Sozialist=социалист
SoЯe=соус
Spaghetti=спагетти
Spalte=трещина
spalten=расщеплять
Span=щепка
Spange=заколка
Spaniel=спаниель
Spanier=испанец
spanisch=испанский
spanischsprachig=испаноязычный
spannend=напряженный
Spanngerдt=натяжное устройство
Spannung=вольтаж
sparen=экономить
Spargel=спаржа
Spargelkraut=капуста спаржевая
sparsam=экономный
Spatel=шпатель
Spaten=лопата
spazierengehen=прогуливаться
spaЯig=забавный
Specht=дятел
Speck=свиное сало
Speiche=спица
Speicher=амбар
Speiserцhre=пищевод
Speisewagen=вагон-ресторан
Spektrum=спектр
Spelze=полова
Sperling=воробей
Sperrad=храповик
sperrig=громоздкий
speziell=специальный
spezifisch=специфичный
Sphinx=сфинкс
Sphдre=сфера; шар
Spickzettel=шпаргалка
Spiegel=зеркало
Spiegeleier=яичница глазунья
Spiel=игра
spielen=играть
Spieler=игрок
Spielhahn=шотландский тетерев
Spielkammerad=товарищ детских игр
spiellustig=игривый
Spielplatz=игровая площадка
Spielzeug=забава
Spielzeugskiste=ящик для игрушек
Spinat=шпинат
Spinne=паук
spinnen=прясть
Spinngewebe=паутина
Spion=шпион
Spionage=шпионаж
Spirale=спираль
Spiritus=спирт
spitze Winkel=острый угол
Spitzmaus=землеройка
Spitzname=прозвище
Spitzzahn=острый зуб
Sponsor=спонсор
spontan=спонтанный
Spore=спора
Sporn=шпорник
Sport=спорт
Sportauto=спортивный автомобиль
Sportbalken=спортивное бревно
Sporthemd=спортивная майка
sportlich=спортивный
Sportmьtze=бейсболка
Sportschuh=тапочка
Sporttaucher=аквалангист
spotten=ухмыляться
Spray=разбрызгиватель
sprechen=говорить
Sprenger=дождевая установка
Sprichwort=пословица
Springbrunnen=фонтан
springen=прыгать
Springer=прыгун
Sprint=спринт
Spritze=шприц
spritzen=впрыскивать
Spross=отпрыск
Sprьhregen=мелкий дождь
spucken=плевать
Spule=катушка
Spur=след
spдhen=высматривать
spдter=более поздний
Spцtter=пересмешник
spцttisches Lдcheln=усмешка
Spьle=мойка
spьlen=полоскать
Spьrhund=ищейка
Staat=государство
Staatsbьrgerschaft=гражданство
Staatsmann=государственный деятель
Stachel=жало
Stachelbeere=крыжовник
Stacheldraht=колючая проволока
stachelig=колючий
Stachelschwein=дикобраз
Stadion=стадион
Stadt=город
Stadtfьhrer=гид
stadtnah=пригородный
stagnierend=застойный
Stahl=сталь
Stall=хлев
Stallbursche=конюх
Stamm=родовой
Stammbaum=родословная
Stammesgenosse=соплеменник
Stampfen=топтание
Standard=стандартный
Standuhr=стоячие часы
Stanniolpapier=оловянная фольга
Stapler=штабелеукладчик
Star=скворец
stark=крепкий
starker Schlag=сильный удар
starker Wind=сильный ветер
starkwirkend=сильнодействующий
starren=пристально глядеть
Starrkrampf=столбняк
Start=старт
Startplatz=стартплощадка
Station=станция
stationдr=стационарный
Statistik=статистика
statistisch=статический
Stativ=тренога
statt=вместо
Statue=статуя
Status=статус
Staubbeutel=пыльник
Staubfaden=тычинка
staubig=пыльный
Staubsauger=пылесос
stauen=тормозить
Stechpalme=остролистник
Stecker=штепсель
Stecknadel=булавка
Steg=дужка
Stegosaurus=стегозавр
stehen=стоять
stehlen=воровать в магазине
steigen=подниматься
Stein=камень
Steinschlossgewehr=кремневое ружье
Stellung=позиция
Stellvertreter=заместитель
Stelzen=ходули
Stemmeisen=стамеска
Stempel=штамп
Steppdecke=стеганое одеяло
Steppe=степь
steppen=стегать
sterben=умирать
Stereo=стерео
Stereoanlage=стерео система
sterilisieren=стерилизовать
Stern=звезда
Sternbild=созвездие
Sternchen=звездочка
Stethoskop=стетоскоп
Steuer=руль
Steuerbord=правый борт
Steuergriff=ручка управления
Steuerkolonne=рулевая колонка
Steuerrad=штурвал
steuerungs fдhig=легко управляемый
Steward=стюард
Stewardess=стюардесса
Stich=укус
sticken=вышивать
Stickerei=вышивка
stickig=спертый
Stiefel=сапог
Stiefmutter=мачеха
Stiefmьtterchen=анютины глазки
Stiefvater=отчим
Stiel=стержень
Stierkampf=бой быков
Stift=штифтик
Stil=стиль
still werden=утихать
Stille=затишье
Stimme=голос
stimmen=настраивать
stimmloser Laut=глухой звук
stimulieren=стимулировать
Stimullus=стимул
stinken=вонять
Stipendiant=стипендиат
Stipendium=стипендия
Stirn=лоб
Stock=палка
stocken=запинаться
Stoff=ткань
Stoffspielzeug=мягкая игрушка
Stoffwechsel=обмен веществ
Stoffwindel=пеленки
stolpern=спотыкаться
stolz=гордый
Stolz=гордость
Stomatologe=стоматолог
stopfen=штопать
Stoppelfeld=стерня
Stoppelrьbe=турнепс
Stoppuhr=секундомер
Storch=аист
stottern=заикаться
stoЯen=толкать
StoЯzahn=бивень
Strafe=наказание
Strahl=луч
Strahlung=излучение
Strand=пляж
Strandhut=сомбреро
Strandkorb=шезлонг
Strandlinie=береговая линия
Stratosphдre=стратосфера
StrauЯ=страус
StraЯe=улица
StraЯenbahn=трамвай
StraЯenrand=бордюр
Strecke=протяжение
Streich=проделка
Streichholz=спичка
Streife=патруль
Streifen=полоса
Streifen ziehen=проводить полосы
Streikposten=пикет
streiten=спорить
streitsьchtig=сварливый
streng=строгий
Stress=стресс
Strichglas=мензурка
Strick=веревка
stricken=вязать
Strickjacke=вязаный жакет
Stricknadel=вязальная спица
Strofe=строфа
Strohhalm=соломинка
Strohmann=подставное лицо
Strom=поток
stromab=вниз по течению
stromabwдrts=по течению
Stromnetz=электропроводка
Stromschnelle=порог реки
Struktur=структура
Strumpf=чулок
Strumpfhose=колготки
Strдhne=прядь
strцmen=струиться
Student=студент
Studio=студия
Studium=изучение
Stufe=ступенька
Stuhl=стул
stumm=немой
stumpfer Winkel=тупой угол
Stunde=час
Sturm=шторм
Sturmvogel=буревестник
Stute=молодая кобыла
stдdtisch=муниципальный
stдndig=постоянный
Stдrke=крепость
stцhnen=стонать
Stцr=осетр
stцren=мешать
Stцrung=задержка
Stьckchen=долька
stьndlich=ежечасный
stьrzen=свергать
Stьtze=подпорка
stьtzen=подпирать
Stьtzpunkt=точка опоры
Subsistenz=подмножество
Substantiv=существительное
Substrahend=уменьшаемое
Subtrahend=вычитаемое
Subtraktion=вычитание
suchen=искать
Sucht=мания, страх
Suffix=суффикс
Sultan=султан
Summe=сумма
summen=гудение
Summen=жужжание
summieren=суммировать
Sumpf=болото
Sumpfstiefel=болотные сапоги
Superlativ=превосходная степень
Suppe=суп
Surfbrett=доска для серфинга
surfen=заниматься серфингом
Symbol=символ
symbolisieren=символизировать
Symmetrie=симметрия
symmetrisch=симметричный
Sympathie=симпатия
sympatisch=симпатичный
sympatisieren=симпатизировать
Symphonie=симфония
Symptom=симптом
Synagoge=синагога
Synonym=синоним
synonymisch=синонимичный
Synthesizer=синтезатор
synthetisch=синтетический
System=система
szenisch=сценический
sдbelzahniger Tiger=саблезубый тигр
Sдge=пила
Sдgemehl=древесные опилки
sдgen=пилить
Sдmaschine=сеялка
Sдnger=певец
sдubern=очищать
Sдugetiere=млекопитающие
Sдugling=грудной ребенок
Sдule=столб
Sдure=кислота
sьd-ostlich=юго-восточный
Sьden=юг
sьdlich=южный
Sьdlдnder=южанин
Sьdosten=юго-восток
sьdwestlich=юго-западный
sьdwestwind=юго-западный ветер
sьdwдrts=к югу
Sьnde=грех
sьЯer machen=подслащивать
SьЯholz=лакричник
SьЯigkeit=сладость
SьЯkartoffel=сладкий картофель
SьЯkirsche=черешня
SьЯwasser=пресноводный
T=тэ
Tabak=табак
Tablett=поднос
Tablette=таблетка
Tadel=осуждение
Tafel=классная доска
Tafelberg=столовая гора
Tafelservice=столовый сервиз
Tag=день
Tagarbeit=работа по найму
Tagebuch=дневник
Tagesarbeit=поденная работа
Tagesdecke=покрывало
Tageslicht=дневной свет
Tagestraum=дневной сон
Taifun=тайфун
Taille=талия
Takelwerk=такелаж
Takt=такт
Taktstock=дирижерская палочка
Tal=долина
Talent=талант
talentiert=талантливый
Talisman=талисман
Tamburin=бубен
Tamtam=тамтам
Tanker=танкер
Tanklastzug=бензовоз
Tanne=елка
Tannenbaum=ель
Tante=тетя
Tanz=танец
Tapete=обои
tapfer=храбрый
Tapir=тапир
Tarantel=тарантул
Tarif=тариф
Tarnanstrich=камуфляж
Tasche=сумочка
Tasche mit Riemen=сумка с ремнем
Taschendieb=вор-карманник
Taschenmesser=карманный нож
Taschenrechner=калькулятор
Tasse=чашка
Tastatur=клавиатура
Tatauierung=татуировка
Tatsache=факт
tatsдchlich=фактический
Tau=роса
taub=глухой
Taube=голубь
tauchen=нырять
Tauchen=ныряние
Taucher=ныряльщик
Tauchgerдt=акваланг
Tauchvogel=чистик
Taufe=крещение
Taufeltern=крестные родители
taufen=крестить
tauglich=годный
tauschen=менять
tausend=тысяча
TausendfьЯler=многоножка
Tauwetter=оттепель
Taverne=таверна
Taxi=такси
taxieren=оценивать
Taxifahrer=таксист
Technik=техника
Techniker=техник
technisch=технический
technische Station=техстанция
Technologie=технология
Tee=чай
Teekanne=чайник
Teelцffel=чайная ложка
Teenager=подросток
Teer=деготь
Teich=пруд
Teig=тесто
Teigwaren=макаронное изделие
Teil=долька
teilbar=делимый
Teilchen=частица
teilen=делить
teilnehmen=участвовать
Teilnehmer=абонент
Teilung=раздел
Teilungslinie=разделительная линия
Teilverdunkelung=частичное затемнение
teilweise=частично
Telefon=телефон
Telegraf=телеграф
Telegramm=телеграмма
Teller=тарелка
Tempel=храм
Temperatur=температура
Tendenz=тенденция
tendieren=иметь тенденцию
Tenne=гумно
Tennis=теннис
Tennisball=теннисный мяч
Tennisplatz=корт
Tennisschlдger=теннисная ракетка
Tenor=тенор
Teppich=ковер
Terasse=терраса
Termite=термит
Terpentin=скипидар
Terrarium=террариум
Terrier=терьер
Terror=террор
terrorisieren=терроризировать
Test=тест
Testament=Завет
teuer=дорого
Teufel=дьявол
Text=текст
textil=текстильный
Textprozessor=текстовый процессор
Textur=ткань
Theater=театр
Thema=тема
Theorie=теория
Therapie=терапия
Thermometer=термометр
Thermosflasche=термос
Thermostat=термостат
Thesaurus=тезаурус
Thron=трон
Thunfisch=голубой тунец
Tiara=тиара
tief=глубокий
Tiefe=глубина
Tiefe messen=измерять глубину
tiefe Verletzung=глубокий порез
Tier=животное
Tiger=тигр
Tinte=чернила
Tintenklecks=клякса
Tisch=стол
Tischdecke=скатерть
Tischtuch=скатерть
Titel=название
Toast=тост
Toaster=тостер
Tochter=дочь
Toga=тога
Toilette=туалет
Toilettenpapier=туалетная бумага
tolerant=терпимый
Tomate=помидор
Ton=глина
Tonbandgerдt=магнитофон
Tonne=тонна
Tonsillitis=тонзиллит
Topas=топаз
Topf=кастрюля
Topographie=топография
Tor=ворота
Torf=торф
Torheit=глупость
Tormann=вратарь
Torpedo=торпеда
Torte=торт
tot=мертвый
Totem=тотем
Totengruft=усыпальница
Toter=покойный
totschlagen=убивать
Tourist=турист
Trab=рысь
traben=бежать рысью
Tradition=традиция
traditionell=традиционный
Tragbahre=носилки
tragbar=портативный
tragbare Funkstation=переносная рация
Tragbrett=лоток
tragen=нести
Tragflдche=крыло
tragisch=трагический
Trainingshose=спортивные брюки
Trakt=тракт
Traktor=трактор
Trampolin=трамплин
Transport=перевозка
Trapez=трапеция
Traube=гроздь
trauen=венчать
Trauerspiel=трагедия
traurig=опечаленный
Trauring=обручальное кольцо
treffen=встречать
Treibhaus=оранжерея
Treibhund=английская гончая
Treibsand=зыбучий песок
trennen=отделять
Tresor=сейф
treten=наступать
treu=преданный
Treue=преданность
Tribьne=трибуна
Trichter=воронка
Trick=трюк
Trickfilmaufnahme=мультипликация
Tricktrack=триктрак
Triebkraft=движущая сила
Trikotage=трикотаж
trinken=пить
Trinkgeld=чаевые
Trio=трио
Triumph=триумф
Triumphwagen=колесница
trocken=сушить
Trockenhaube=сушилка для волос
Trockner=сушилка
Trog=корыто
Trommel=барабан
Trommelfell=барабанная перепонка
Trommelstock=барабанная палочка
Trompete=труба
Tropen=тропики
tropfen=капать
Tropfen=капля
Tropfenzдhler=пипетка
Trophдe=трофей
tropisch=тропический
trotten=идти рысью
trotz=несмотря на
Trunksucht=алкоголизм
Truthahn=индюк
trдumen=видеть сны
Trдumer=мечтатель
Trдumerei=грезы
trцsten=утешать
trьbe=тусклый
Trьbung=помутнение
trьgerisch=призрачный
Trьmmer=обломки
Tuba=туба
Tube=тюбик
Tuberkulose=туберкулез
Tuch=платок
Tuchhalter=полотенцедержалка
Tugend=добродетель
Tukan=тукан
Tulpe=тюльпан
Tundra=тундра
Tunke=подливка
Tunnel=туннель
Turban=тюрбан
Turbine=турбина
Turm=колонна, вышка
Turmuhr=куранты
Turnen=гимнастика
Turner=гимнаст
Turnhalle=гимнастический зал
Turnier=турнир
Turnsaal=гимнастический зал
Tusche=тушь
Tweed=твид
typisch=типичный
Tyrann=тиран
Tyrannei=тирания
tyrannisch=тиранический
Tyranosaurus=тиранозавр
tдglich=ежедневный
Tдnzer=танцор
Tдtigkeit=деятельность
Tдuschung=иллюзия
tцdlich=смертельный
tцnend=звучащий
Tцpfer=гончар
Tцpferei=гончарная мастерская
tцten=убивать
tьchtig=дельный
tьckisch=коварный
Tьr=дверь
Tьrhammer=дверной молоток
Tьrkis=бирюза
Tьrklingel=дверной звонок
Tьrklinke=дверная ручка
Tьrverschluss=дверной замок
Tьrцffnung=дверной проем
U=у
U-Bahn=метро
U-Bahnschalter=касса метро
U-Bahnstation=станция метро
Ufer=берег
Uhr=часы
Uhrzeiger=часовая стрелка
Uhu=филин
Ukulele=гавайская гитара
Ulme=вяз
umarbeiten=переделывать
umarmen=обнимать
umbauen=перестраивать
umbinden=завязывать
umdrehen=переворачивать
umfallen=валиться
Umfang=диапазон
umfassen=охватывать
umfassend=обильный
umformulieren=менять формулировку
Umgang=общение
umgeben=окружать
Umgebung=окружение
Umgebungen=окрестности
umgekehrt=наоборот
umherirren=скитаться
umherliegen=валяться
Umlauf=циркуляция
umlegen=перекладывать
umpflanzen=пересаживать
Umschalter=переключатель
Umschlag=обертка
umschreiben=переписывать
umsichtig=осмотрительный
Umsiedler=переселенец
Umstellung=перемещение
umstrцmt=обтекаемый
Umweg=обход
umwerfen=опрокидывать
umwesentlich=неважный
umziehen=переселяться
umzingeln=окружать
Umzдunen=огораживание
Umzдunung=ограждение
unabhдngig=независимый
Unachtsamkeit=недосмотр
unangenehm=неприятный
unangenehm sein=быть неприятным
unangenehme Situation=неприятное положение
unansehnlich=неприглядный
Unanstдndigkeit=непристойность
unaufhaltsam=безудержный
Unaufmerksamkeit=невнимание
unaufregend=не встревоженный
unaufrichtig=неискренний
unaufschiebbar=неотложный
unbarmherzig=безжалостный
unbebauter Platz=пустырь
unbedingt=непременно
unbefriedigend=неудовлетворительный
unbefriedigt=неудовлетворенный
unbegrenzt=неограниченный
unbekannt=неизвестный
Unbekannte=незнакомец
unbemerkbar=незаметный
unbenutzt=неиспользованный
unbequem=неудобный
Unbequemlichkeit=неудобство
unbesetzt=незанятый
unbestimmt=неопределенный
unbetont=безударный
unbewusst=бессознательный
unbewцlkt=безоблачный
unbrechbar=несломленный
undankbar=неблагодарный
undenkbar=невообразимый
undeutlich=неразборчивый
undurchdringlich=непроницаемый
uneben=шероховатый
unehrlid=нечестный
uneinheitlich=неоднозначный
Uneinigkeit=разногласие
unendlich=бесконечный
unentschieden=нерешенный, ничейный
unentschlossen=нерешительный
unentwickelt=неразвитый
unerfahren=неопытный
unerfьllbar=невыполнимый
unermesslich=необъятный
unertrдglich=невыносимый
unerwartet=неожиданный
unerwiesen=неустановленный
unerzдhlt=нерассказанный
Unfall=несчастный случай
Unfallhilfe=скорая помощь
unfreundlich=недружелюбный
unfruchtbar=бесплодный
unfдhig=неспособный
unfдhig machen=делать неспособным
Unfдhigkeit=неспособность
unfцrmlich=неформальный
ungebrдuchlich=ненужный
Ungeduld=нетерпение
ungeduldig=нетерпеливый
ungefдhr=приблизительный
ungeheuer=чудовищный
Ungeheuer=чудовище
ungehorsam=непослушный
ungehцrt=неслыханный
ungekonnt umgehen=неумело обращаться
ungekдmmt=нечесанный
ungelernt=необученный
ungenau=неточный
ungerade=нечетный
ungerecht=несправедливый
ungeschickt=неуклюжий
ungestьm=стремительный
ungesund=нездоровый
ungewiss=неопределенный
Ungewissheit=невежество
ungewohnt=необычайный
ungewцhnlich=необычный
unglaublich=невероятный
Ungleichheit=неравенство
Unglьck=несчастья
unglьcklich=несчастливый
Ungnade=немилость
unheilverkьndend=зловещий
unheilvoll=зловещий
unhцflich=невежливый
Uniform=униформа
Union=союз
Unisono=унисон
Universitдt=университет
Universitдtviertel=университетский городок
Universum=вселенная
unklar=неясный
Unkraut=сорняк
unmenschlich=бесчеловечный
unmoralisch=аморальный
unmцglich=невозможный
unmьndig=несовершеннолетний
unnatьrlich=неестественный
unordentlich=беспорядочно
Unordnung=беспорядок
unpassend=неподходящий
unplaziert=не в цель
UnpдЯlichkeit=недомогание
Unrecht=несправедливость
unreif=незрелый
unrein=нечистый
unrichtig=неправильный
unrichtig lesen=неправильно читать
Unrichtigkeit=неправильность
Unruhe=тревога
Unruhen=беспорядки
unruhig=беспокойный
uns=нас
unscheinbar=невзрачный
Unschuld=невинность
unschuldig=невинный
unschдtzbar=бесценный
unser=наш
unsicher=небезопасный
unsichtbar=невидимый
Unsinn=чушь
unsinnig=нелепый
unsterblich=бессмертный
Unstimmigkeit=разногласие
unteilbar=неделимый
unten=вниз
unter=под
Unterarm=предплечье
unterbrechen=прерывать
Unterbrechung=прерывание
unterbringen=поместить
unterdrьckt=угнетенный
Unterdrьckung=угнетение
Untergang=заход солнца
Untergebene=младший по чину
Unterhalt=пособие
unterhalten=развлекать
Unterhaltung=развлечения
Unterhemd=нижняя рубашка
Unterholz=подлесок
Unterhose=кальсоны
unterirdisch=подземный
unterjochen=порабощать
Unterkunft=приют
untermauern=подкреплять
unternehmen=предпринимать
Unternehmen=предприятие
Unternehmer=предприниматель
Unterricht=обучение
Unterrock=нижняя юбка
unterscheiden=различать
Unterschenkel=голень
Unterschied=различие
unterschreiben=подписываться
Unterschrift=подпись
Unterseeboot=подводная лодка
unterseeisch=подводный
unterstreichen=подчеркивать
unterstьtzen=поддерживать
Unterstьtzung=поддержание
untersuchen=исследовать
Untersuchung=исследование
Untersuchungstisch=стол для осмотра
Untertasse=чайное блюдце
untertauchen=окунаться
unterteilen=подразделять
Unterwдsche=нижнее белье
unterwьrfig=покорный
unumkehrbar=обратимый
ununterbrochen=беспрерывный
unvergesslich=незабываемый
unverheiratet=незамужняя
unvermeindlich=неизбежный
Unvernunft=безрассудство
unverstдndig=неразумный
unverzagt=неунывающий
unverдnderlich=неизменившийся
unvollkommen=несовершенный
Unvollkommenheit=несовершенство
unvorbereitet=неподготовленный
unvoreingenommen=непредвзятый
unvorsichtiges Wort=неосторожное слово
unwahrscheinlich=неправдоподобный
unwillkьrlich=непроизвольный
unwissend=неграмотный
unwohlriechend=непахнущий
Unze=унция
unzerbrechlich=неломкий
Unzufriedenheit=недовольство
unzuverlдssig=ненадежный
unдhnlich=непохожий
unьberwindlich=непреодолимый
Uran=уран
Ureinwohner=абориген
Urenkel=правнук
UrgroЯmutter=прабабушка
UrgroЯvater=прадед
Urin=моча
Urlaub=отпуск
Urlaubnorm=норма отпуска
Urquelle=первоисточник
Ursache=причина
Ursprung=источник
ursprьnglich=первоначальный
Urtierchen=амеба
Urvater=прародитель
V=фау
Vakuum=вакуум
Vanille=ваниль
Vasall=вассал
Vase=ваза
Vater=отец
vegetarisch=вегетарианский
Veilchen=фиалка
Vene=вена
Venus=Венера
Verachtung=презрение
verallgemeinern=обобщать
Verallgemeinerung=абстракция
veraltet=устарелый
Veranda=веранда
Veranschaulichung=иллюстрация
verantwortlich=ответственный
Verantwortung=ответственность
Verb=глагол
Verbannter=изгнанник
Verbannung=ссылка
verbessern=улучшать
Verbesserung=улучшение
verbieten=запрещать
verbinden=присоединять
Verbindung=соединение
Verbindungstrabant=спутник связи
Verblendung=ослепление
verblьffen=озадачивать
verblьhen=увядать
verborgenes Manцver=скрытый маневр
Verbot=запрет
Verbrauch=расход
verbrauchen=потреблять
Verbraucher=потребитель
Verbrechen=преступление
Verbrecher=преступник
verbrecherisch=преступный
verbreiten=испускать
verbreitet=распространенный
verbrennen=обжигать
verbrennt=сожженный
Verbrennung=ожог
Verbum transitivum=переходный глагол
verbunden=связанный
verbьndet=союзный
Verbьndete=союзник
verdampfen=испарять
Verdauung=пищеварение
Verdauungsstцrung=несварение
Verdauungstrakt=пищеварительный тракт
verderblich=пагубный
verdichten=сгущать
Verdichtung=конденсация
verdienen=заслуживать
Verdienst=заслуга
Verdikt=вердикт
Verdruss=досада
verdrдngen=вытеснять
verdunkeln=затемнять
verdдchtig=подозрительный
Verdдchtige=подозреваемый
Verehrer=поклонник
vereinbaren=договариваться
vereinfachen=упрощать
vereinigen=объединять
Vereinigung=соединение
vereint=совокупный
Vereisung=обледенение
Vererbungslehre=генетика
verewigen=увековечивать
Verfahren=процедура
verfassungsmдЯig=конституционный
Verfolgung=преследование
Verfvielfдltigung=размножение
Verfьgung=расположение
verfьhren=искушать
vergangen=прошедший
Vergangenheit=прошлое
Vergaser=карбюратор
vergeblich=тщетный
vergessen=забывать
vergesslich=забывчивый
vergieЯen=проливать
vergiften=отравлять
VergiЯmeinnicht=незабудка
Vergleich=сравнение
Vergleichen=сверка
vergleichend=сравнительный
Vergnьgen=удовольствие
vergolden=покрывать позолотой
vergrцЯern=увеличивать
VergrцЯerung=увеличение
vergдnglich=преходящий
Verhafteter=арестант
Verhaftung=арест
Verhaftungsraum=арестантская
Verhalten=отношение
Verhandlungen=переговоры
verheimlichen=утаивать
verhindern=предотвращать
Verhinderung=предотвращение
Verhдltnisse=отношения
verhцhnen=издеваться над
Verhцrliste=лист допроса
verhьten=предотвращать
verirrt=заблудившись
verjagen=изгонять
Verkauf=продажа
verkaufen=продать
Verkehr=уличное движение
verkehrend=сообщающийся
Verkehrsampel=светофор
Verkehrsflugzeug=воздушный лайнер
Verkehrsmittel=транспортное средство
Verkehrspolizei=автоинспекция
Verkehrswesen=общественный транспорт
Verkehrszeichen=дорожный знак
verketten=связывать
verkleiden=обшивать
verkleinern=уменьшать
Verkдufer=торговец
Verkдuferin=продавщица
verkцrpern=олицетворять
verkьndigen=провозглашать
Verkьndigung=провозглашение
verkьrzen=сокращать
Verkьrzung=сокращение
Verlachen=осмеяние
Verladung=отгрузка товаров
verlangen=требовать
verlassen=покинутый
Verlegenheit=смущение
Verleger=издатель
verleihen=присваивать
verletzen=повредить
Verletzung=повреждение
Verleumdung=клевета
verlieren=терять
verloren=потерянный
verlumpt=в лохмотьях
Verlust=потеря
verlдngern=удлинять
vermindern=ослаблять
Verminderung=уменьшение
vermischen=размешивать
vermisst=потерявшийся
verneinen=отрицать
verneinend=отрицательный
vernichten=уничтожать
vernichtend=разрушительный
Vernichtung=уничтожение
Vernunft=благоразумие
vernьnftig=разумный
Verpacken=упаковка
verpflichten=обязывать
verpflichtend=обязанный
verpflichtet=обязанный
Verpflichtung=обязательство
verprьgelt=избитый
Verpuffung=вспышка
Verrat=предательство
verraten=предавать
verrenken=вывертывать
verrдterisch=предательский
verrьckt=полоумный
versammeln=собирать
Versammlung=собрание
versanden=посыпать песком
verschaffen=разминать
Verschiebung=передвижение
verschieden=различный
Verschiedenartigkeit=разнообразие
verschimmelt=заплесневелый
verschlimmern=ухудшать
verschlimmerung=ухудшать
verschlingen=поглощать
Verschluss=замок
verschlьsseln=кодировать
verschmutzen=загрязнять
verschwenderisch=расточительный
verschwinden=исчезать
versetzen=перемещать
versichern=уверять
Versicherung=страхование
Version=версия
versorgen=снабжать
versorgt=обеспеченный
Versorgung=попечительство
verspotten=насмехаться
versprechen=обещать
verspдten=запаздывать
verspдtet=запоздалый
Versteckspiel=игра в прятки
verstehen=понимать
Verstellung=притворство
verstreuen=рассеивать
verstдndig=смышленый
Verstдndnis=понимание
verstдrken=усиливать, укреплять
Versuch=испытание
Versuchung=искушение
versцhnen=умиротворять
VersьЯung=подсластитель
vertagen=отсрочивать
Verteidiger=защитник
verteidigung=оборонный
Verteidigung=защита
verteilen=распределять
verteilt=разъединенный
Verteilung=распределение
Vertrag=контракт
Vertrauen=доверие
vertraulich=конфиденциальный
Vertreter=представитель
Vertдuboje=швартовочный буй
vertдuen=причаливать
verunreinigen=сорить
Verunreinigung=загрязнение
verwachsen=зарастать
Verwaltung=администрация
verwandeln=превращать
Verwandlung=превращение
Verwandschaft=родня
verwandt=родственный
Verwandte=родственник
verwandtschaftlich=родственный
Verweis=нотация (нравоучение)
Verweisung=ссылка
Verwendung=применение
verwesen=гнить
verwickeln=запутывать
Verwirklichung=реализация
verwirren=сбивать с толку
Verwirrung=замешательство
verworrenes Knдuel=спутанный клубок
verwцhnen=баловать
verwцhnt=избалованный
verwьsten=опустошать
verzagt=унылый
verzeihen=прощать
Verzeihung=прощение
verzichten=отказывать
verzweifelt=отчаянный
Verzweiflung=отчаяние
Verzweiflungsschrei=крик отчаяния
verдchtlich=презрительный
verдndern=переделывать
Verдnderung=изменение
verцffentlichen=объявлять
Veteran=ветеран
Veterinдr=ветеринар
Veto=вето
Vetter=двоюродный брат
Vibration=вибрация
vibrieren=вибрировать
Video=видео
Videokamera=видеокамера
Videokassette=видеокассета
Videorecorder=видеомагнитофон
Viehhof=загон для скота
Viehwдrter=скотник
viel=много
Vieleck h=многоугольник
VielfraЯ=росомаха
vielleicht=может быть
vielseitig=универсальный
vielversprechend=многообещающий
vier=четыре
vierfьssig=четвероногое
Viergespann=четверня
Viertel=квартал
Viertel des Dollars=четверть доллара
vierteljдhrlich=ежеквартальный
vierzehn=четырнадцать
vietnametisch=вьетнамский
Villa=особняк
Violinbogen=смычок
Violine=скрипка
Violoncello=виолончель
Virus=вирус
Viskose=вискоза
Vitamin=витамин
Vizeprдsidend=вице-президент
Vogel=птица
Vogelart=вид птицы
Vogelscheuche=пугало
Vokal=гласный
Volk=народ
Volkskunst=фольклор
Volksmдrchen=народная сказка
voll=полный
vollblьtig=налитый кровью
volle Tasse=полная чашка
Vollendung=завершение
Voller Mund=полный рот
Volleyballspiel=волейбол
Volljдhrigkeit=совершеннолетие
vollkommen=совершенный
Vollmacht=доверенность
vollstдndig=полностью
vollziehend=исполнительный
Volt=вольт
vom Winde verfolgt=гонимый ветром
von=с
von neuem=снова
vor=перед
vor sich hinsingen=напевать
Vorabend=канун
vorangehen=предшествовать
vorangehend=предшествующий
vorausbestimmt=предрешенный
vorausschicken=предпосылать
Voraussicht=предвидение
vorbei=мимо
Vorbereitung=подготовка
vorbeugend=предупредительный
vordere=передний
Vorderpfote=передняя лапа
Vorderscheibe=лобовое стекло
VorderstoЯstange=передний бампер
Vorderteil=передняя часть
Vorfahr=предок
vorfьhren=показывать
Vorfьhrung=показ, демонстрация
Vorgabespiel=гандикап
Vorgarten=палисад
vorgehen=продвигаться
vorgeschichtlich=доисторический
Vorgesetzte=начальник
Vorgдnger=предшественник
vorhaben=замышлять
Vorhalle=веранда
Vorhang=занавес
vorherrschend=доминирующий
vorhersagen=предсказывать
vorige=прошлый
vorkommen=иметь место, случаться
Vorkommnis=случай
Vorlesung=лекция
Vorliebe=пристрастие
vorlдufig=предварительный
Vorort=пригород
Vorortzug=пригородный поезд
Vorposten=аванпост
Vorrat=запас
Vorrecht=привилегия
vorrдtig=запасной
vorrьcken=выдвигать
Vorrьcken=продвижение
vorsagen=подсказывать
vorschieben=продвигать
Vorschlag=предложение
Vorschlaghammer=кувалда
vorschreiben=предписывать
Vorschrift=предписание
vorsehen=предвидеть
Vorsicht=осторожность
Vorsitzende=председатель
vorspringend=выскочивший
Vorsprung=выступ
Vorstellung=представление
Vorteil=преимущество
vorteilhaft=выгодный
Vortrag=доклад
vortragen=декламировать
vortrefflich=превосходный
Vorwort=предисловие
vorwдrts=передовой
Vorzeichen=предзнаменование
vorzeitig=преждевременный
vorziehen=предпочитать
Vorzugs=приоритетный
vulgдr=вульгарный
Vulkan=вулкан
vдterlich=отцовский
vцllig=полный
W=вэ
Waage=весы
waagerecht=горизонтальный
Wache=стража
Wachmann=вахтер
Wacholder=можжевельник
Wachposten=сторожевой пост
Wachs=воск
Wachsamkeit=бдительность
wachsen=расти
Wachsen=рост
wackelig=шаткий
Waffe=оружие
Waffel=вафля
Waffenschmiede=арсенал
Waffenstillstand=перемирие
wagen=сметь
Wagen=вагон
Wagenheber=домкрат
Wahlerfolg=победа на выборах
wahr=правдивый
wahrhaftig=поистине
Wahrheit=правда
Wahrnehmung=восприятие
Wahrsagerin=гадалка
wahrscheinlich=вероятный
Wahrscheinlichkeit=вероятность
Waise=сирота
Waisenhaus=приют для сирот
Wal=кит
Wald=лес
Waldbau=строительство леса
Waldgrenze=граница леса
waldig=лесистый
waldreiches Tal=лесистая долина
walesisch=уэльский
Walfischboot=китобойное судно
Waljagd=охота на китов
Walkman=уокмен
Walnuss=орех грецкий
Walross=морж
Walze=валик
Walzer=вальс
Wand=стена
Wanderer=скиталец
Wanderung=миграция
Wandtafel=классная доска
Wandteil=отделение стенки
Wange=щека
wann=когда
Wanne=ванна
war=был
Waren=изделия
Warenballen=тюк
Warenhaus=универмаг
warm=тепловатый
warmblьtig=теплокровный
Warmwasserhahn=кран горячей воды
warnen=предупреждать
Warnung=предупреждение
warten=ждать
warum=почему
Warze=бородавка
was=что
Waschbecken=раковина
Waschbдr=енот
waschen=мыть
Waschmaschine=стиральная машина
Waschmittel=моющее средство
Waschpulver=стиральный порошок
Waschtuch=тряпка для мытья
Wasser=вода
Wasser durchlassen=промокать
Wasserabflussrinne=водосток
Wassercresse=кресс салат
wasserdicht=непромокаемый
wasserdichter Anzug=непромокаемый костюм
Wasserfall=водопад
Wasserflugzeug=гидроплан
Wasserglas=стакан для воды
Wasserhahn=водопроводный кран
Wasserleitung=водопровод
wasserlos=безводный
Wassermaulkorb=водяной щитомордник
Wassermelone=арбуз
Wasserrad=водяное колесо
Wasserscheide=водораздел
Wasserscheu=водобоязнь
Wasserski=водные лыжи
Wasserstoff=водород
Wasserstoffbombe=водородная бомба
Wasserstrudel=водоворот
Wasserwirbel=водоворот
watscheln=ходить вразвалку
Watteeinlage=ватный тампон
weben=ткать
Webstoff=тканый материал
Wechsel=переменный
Wechselbeziehungen=взаимоотношения
wecken=разбудить
wedeln=вилять
Weg=путь
weg!=прочь
Wegerich=подорожник
Wegfall=отмена
wegfressen=разъедать
weggehen=отходить
weggehend=уходящий
wegjagen=отгонять
weglaufen=убегать
weglegen=откладывать
wegnehmen=отнимать
Wegseite=обочина
wegwerfen=выбрасывать
wehen=дуть
Wehmut=печаль
Wehrwache=дорожная застава
weiblich=женский
weich=мягкий
weicher werden=смягчаться
Weichheit=мягкость
Weide=ива
weiden=пасти
Weihnachten=рождество
Weihrauch=ладан
Wein=вино
weinen=плакать
Weingarten=виноградник
Weinglas=бокал
Weinrebe=виноградная лоза
Weintraube=виноград
Weintrauben=виноград
weis=мудрый
Weise=мудрец
weisen=указывать
Weisheit=мудрость
Weissagung=предсказание
weit=далеко
Weite=простор
weiter=дальше
weiterfahren=идти далее
weitsichtig=дальнозоркий
Weizen=пшеница
Weizenfeld=пшеничное поле
weiЯ=белый
weiЯe Johannisbeere=белая смородина
weiЯen=белить
welcher=какой
Welle=волна
wellig=волнистый
Welpe=щенок
weltweit=всемирный
wen=кого
Wendeltreppe=веревочная лестница
wenn=если
wenn immer=когда бы ни
wer=кто
werben=рекламировать
Werbung=реклама
werden=становиться
werfen=бросать
Werft=верфь
Werk=завод
Werkangestellte=цеховой служащий
Werkbank=верстак
Werkstatt=мастерская
Werkzeugsschachtel=ящик для инструментов
Wert=ценность
wertvoll=стоящий
Wesen=сущность
wesentlich=существенный
Wespe=оса
wessen=чей
Weste=жилет
Westeinwohner=житель запада
westlich=западный
Wettbewerb=соревнование
wettbewerben=соревновательный
Wette=пари
wetten=держать пари
Wetter=погода
Wetterfahne=флюгер
Wetterprognose=прогноз погоды
Whisky=виски
wichtig=важнейший
wichtiger=более важный
Wichtigkeit=важность
Wichtigtuerei=позерство
Wickelkind=младенец
widerlich=противный
widerspiegeln=отражать
Widerspieglung=отражение
widersprechen=возражать
Widerstand=противоборство
widerstandsfдhig=выносливый
Widerstandskraft=выносливость
widerstehen=противостоять
widmen=посвящать
wie=как
wie lebendig=как живой
Wiedehopf=удод
wieder=вновь
wieder erscheinen=снова появляться
wiederaufbauen=восстанавливать
wiederaufleben=возрождать
wiederbeleben=воскрешать
Wiedergabe=воспроизведение
wiedergeben=воспроизводить
Wiedergeburt=возрождение
Wiederherstellung=восстановление
wiederholen=повторять
Wiederholung=повторение
Wiederkдuen=жвачка
Wiedersehen=встреча
wiedersprьchlich=противоречащий
Wiedervereinigung=воссоединение
Wiege=колыбель
wiegen=взвешивать
Wiegenlied=колыбельная
wiehern=негромко ржать
Wiese=луг
wieviel=сколько
Wigwam=вигвам
Wikinger=викинг
wild=дикий
Wildente=дикая утка
Wildfang=сорванец
Wildkatze=кошка дикая
Wildleder=замша
willkьrlich=произвольный
wimmeln=кишеть
Wimpel=вымпел
Wimper=ресница
Wind=ветер
Windblasen=дуновение ветра
Winde=лебедка
Windel=пеленка
Windeln=детские пеленки
winden=вить
Windhund=борзая
windig=ветреный
Windjacke=ветровка
Windmьhle=ветряная мельница
Windpocken=ветрянка
WindstoЯ=сильный порыв ветра
Windsurfing=виндсерфинг
Wink=намек
winseln=скулить
Winter=зима
Winterschlaf=зимняя спячка
winzig=крошечный
wir=мы
wirbel=позвоночное
Wirbel=позвонок
wirbellos=беспозвоночный
Wirbelsдule=позвоночный столб
wirklich=действительный
Wirklichkeit=реальность
Wirkung=воздействие
wischen=вытирать
Wissbegierde=любознательность
wissbegierig=любознательный
wissen=знать
wissend=знающий
Wissenschaftler=ученый
wissenschaftlich=научный
Witwe=вдова
Witz=анекдот
Woche=неделя
Wochenende=уик-энд
Wochentag=будний день
Wohlergehen=благополучие
wohlerzogen=благовоспитанный
wohlgenдhrt=упитанный
Wohlgeruch=духи
Wohlstand=благосостояние
Wohltat=благодеяние
Wohltдtigkeit=благотворительность
wohlwollend=доброжелательно
wohnen=проживать
wohnhaft=проживающий
Wohnheim=общежитие
Wohnraum=жилое помещение
Wohnung=жилище
Wolf=волк
Wolke=облако
Wolldecke=шерстяное одеяло
wollen=шерстяной
worauf=после чего
Wort=слово
Wortschatz=словарный запас
Wortspiel=каламбур
Wunde=рана
Wunder=чудо
wunderbar=замечательный
wundertдtig=чудотворный
Wurf=метательный
WurfspieЯ=дротик
Wurm=червяк
Wurst=колбаса
Wurzel=корень
Wut=ярость
Wдchter=сторож
wдhlbar=разборчивый
wдhlen=выбирать
Wдhler=избиратель
Wдhlerliste=список избирателей
wдhlte=выбрал
wдhrend=в то время как
Wдhrungsgeld=валюта
Wдrme=теплота
wдrmen=нагревать
Wдrmflasche=грелка
Wдschegarnitur=белье
Wдscheklammer=прищепка
Wдschekorb=корзина для белья
Wдscheleine=веревка для белья
Wдscherei=грязное белье
Wдschetisch=стол для белья
wдssern=поливать
Wдsserung=приводнение
wцchentlich=еженедельный
Wцlfe=волки
Wцrterbuch=словарь
wьnschen=пожелать
Wьrde=достоинство
wьrdig=достойный
Wьrfel=куб
Wьrfelbaukasten=ящик с кубиками
wьrgen=душить
Wьrstchen=сосиска
Wьrze=приправа
wьrzen=приправлять специями
Wьste=пустыня
wьten=бушевать
wьtend=яростный
X=икс
Xylophon=ксилофон
Y=ипсилон
Yankee=янки
Z=цэт
zaghaft=робкий
Zahl=число
zahlen=платить
zahlreich=многочисленный
Zahlscheck=платежный чек
Zahlstelle=касса
Zahlungsliste=платежная ведомость
zahm=прирученный
Zahn=зуб
Zahnbein=дентин
Zahnbьrste=зубная щетка
Zahnfleisch=десна
Zahnpasta=зубная паста
Zahnschmerz=зубная боль
Zahnstocher=зубочистка
Zahnwand=зубчатая стена
Zange=щипцы
zanken=ссориться
zart=милый
Zauber=очарование
Zauberer=колдун
Zaun=забор
Zaunkцnig=крапивник
Zebra=зебра
Zehe=палец ноги
Zehenagel=ноготь пальца ноги
zehn=десять
Zehner=10 пфеннингов
Zeichen=знак
zeichnen=чертить
Zeichnen=черчение
zeichnete=чертил
Zeigefinger=указательный палец
zeigen=показывать
Zeit=время
Zeitalter=эра
Zeitgenosse=современник
Zeitschrift=журнал
Zeitschriftenabteilung=секция периодики
Zeitung=газета
Zeitungskiosk=газетный киоск
zeitweilig=временный
Zellophan=целлофан
Zelluloid=целлулоид
Zellulose=целлюлоза
Zelt=палатка
Zement=цемент
Zementwagen=цементовоз
Zenit=зенит
Zentimeter=сантиметр
zentral=центральный
Zepter=скипетр
zerbrechen=разбивать
zerbrechlich=хрупкий
zerdrьcken=давить
Zerfall=распад
zerhacken=рассекать
zerlegen=разлагаться
zerlegend=разлагаемый
zerreiben=растирать
Zerrung=растяжение
zerschlagen=разбить вдребезги
Zerschlagung=разгром
zerstreut=рассеянный
Zerstreuung=развлечение
zerstдuben=разбрызгивать
zerstцren=разрушать
Zerstцrer=разрушитель
Zerstцrung=разрушение
Zeuge=свидетель
Zeugebank=место свидетеля
zeugen=свидетельствовать
Zeugenaussage=показание свидетеля
Zickzack=зигзаг
Ziege=коза
Ziegel=кирпич
Ziegenbart=козлиная бородка
Ziegenbock=козел
ziehen=тянуть
Ziehklingen=циклевка
Ziel=цель
zielbewust=целеустремленный
ziellos=бесцельный
Zielscheibe=мишень
ziemlich groЯ=довольно большой
Zierpflanze=дикорастущее растение
Zieselmaus=суслик
Ziesemaus=суслик
Ziffern=цифровой
Zigarette=сигарета
Zigarre=сигара
zigeunerisch=цыганский
Zimmer=комната
Zimmerdecke=потолок
Zimmerfliege=комнатная муха
Zimmerfreund=товарищ по комнате
Zimmermann=плотник
Zimmerpflanze=комнатное растение
Zimt=корица
Zink=цинк
Zinnia=цинния
Zirkulation=циркуляция
zirkulieren=циркулировать
Zirkus=цирк
zischen=шипеть
Zitat=цитата
Zither=цитра
zitieren=цитировать
Zitoplasme=цитоплазма
Zitrone=лимон
zittern=дрожать
zivil=гражданский
Zivilisation=цивилизация
zivilisieren=цивилизовать
Zivilist=гражданское лицо
Zobel=соболь
Zodiakus=зодиак
Zoll=дюйм
Zone=зона
Zoo=зоопарк
Zopf=косичка
Zorn=гнев
zornig betrachten=сердито смотреть
zu=к
zu FuЯ=пешком
zu FuЯ gehen=идти пешком
zu FuЯ reisen=путешествовать
zu Mittag essen=обедать
zu schwer=слишком тяжелый
zubereiten=готовить
Zubinden=завязывание
Zuchinie=цуккини
Zucker=сахар
Zuckerdose=сахарница
Zuckermelone=дыня мускусная
Zuckerrohr=сахарный тростник
Zuckersaft=сироп
zufrieden=довольный
zufдllig=случайный
Zug=поезд
zukommend=приближающийся
Zukunft=будущее
zulassen=допускать
zum Glьck=к счастью
zum Schreiben=для письма
Zuneigung=благосклонность
Zunge=язык
zunichte machen=сводить на нет
zupfen=дергать
zur Hдlfte=наполовину
zur Seite treten=отступать в сторону
zurьck=обратный
zurьckbekommen=получить обратно
zurьckberufen=призывать обратно
zurьckbleiben=отставать
zurьckkehren=возвращаться
Zurьcknahme=взятие обратно
zurьcknehmen=взять обратно
zurьckschieben=отодвигать назад
zurьckspringen=подпрыгивать
zurьcktreten=отступать
Zusammenarbeit=сотрудничество
zusammenballen=сжимать
Zusammenbruch=крушение
zusammengerollt=съежившийся
zusammengesetzt=составной
zusammenrollen=свертывать
zusammenschrumpfen=съеживаться
zusammensetzen=собирать
zusammensparen=накапливать
ZusammenstoЯ=столкновение
zusammenstoЯen=сталкиваться
zusammentreffen=совпадать
zusammenziehen=стягивать
Zuschauer=зритель
Zuschauerplдtze=места для зрителей
Zutritt=доступ
zuverlдssig=надежный
zuvorkommen=опередить
zwanzig=двадцать
zwei=два
Zweifel=сомнение
zweifelhaft=сомнительный
zweifeln=сомневаться
Zweig=ветвь
Zweikampf=единоборство
zweimal=дважды
zweisprachig=двуязычный
Zweistoffsystem=двоичная система
zweiter Summand=второе слагаемое
Zweitschrift=дубликат
Zwiebel=лук
Zwielicht=полу мрак, сумерки
Zwillinge=близнец
zwingen=заставлять
zwischen=между
zwischenstaatlich=междуштатный
Zwischenzeit=промежуток времени
Zwitschern=щебет
zwцlf=двенадцать
Zyklone=циклон
Zylinder=цилиндр
zylindrisch=цилиндрический
Zypern=Кипр
Zypresse=кипарис
Zyste=киста
Zдhler=счетчик
Zдhlung=перепись
zдhmen=приручать
Zдhne=зубы
Zдrtlichkeit=ласка
zьchten=разводить
Zьgel=поводья
Zьndung=зажигание
Дquator=экватор
Дrger=ярость
Дrmel=рукав
Дther=эфир
Цdland=пустошь
Цffner=открывалка
Цkologie=экология
Цkosystem=экосистема
Цlpumpe=бензонасос
Цlsonde=масляный щуп
Цltanker=нефтегрузный танкер
Цsterreich=Австрия
Цsterreicher=австралиец
Ьbelkeit=тошнота
Ьberbevцlkerung=перенаселенность
Ьberfall=нападение
Ьberfluss=изобилие
Ьbergang=переход
Ьberladung=загромождение
Ьberrest=пережиток
Ьberschrift=надпись
Ьberschuss=избыток
Ьberschwemmung=наводнение
Ьbersee=за морем
Ьbersetzung=перевод
Ьberstunden=сверхурочная работа
Ьberwachungsturm=надзорная башня
Ьberzeugung=убеждение
Ьbung=упражнение
дgyptisch=египетский
дhnlich=похожий
дhrige Minze=мята колосистая
дlter=старший
дquatorial=экваториальный
дrgern=приводить в ярость
дrmlich=скудный
дsthetisch=эстетический
дtzend=острый
дuЯern=выражать
дuЯerst=крайне
цkonomisch=экономический
цlen=смазывать маслом
цstlich=восточный
ьber=над
ьber dem Kopf=над головой
ьberall=повсюду
ьbereifrig sein=перестараться
ьberfallen=напасть
ьberflieЯen=переливаться
ьberfдllig=просроченный
ьberfьllen=переполнять
ьbergeben=передавать
ьberholen=перерастать
ьberladen=перегружать
ьberlegen=обдумывать
ьberlisten=перехитрить
ьbermдЯig=чрезвычайно
ьbernatьrlich=сверхъестественный
ьbernehmen=принять на себя
ьberqueren=переходить пределы
ьberschreiten=преступать закон
ьberschьssig=избыточный
ьberschьtten=расточать
ьbersehen=недосмотреть, пропустить
ьbersteigen=превышать
ьbertreffen=превосходить
ьbertreiben=преувеличивать
ьbertцnen=заглушать
ьberwinden=преодолеть
ьberwдltigen=побороть
ьberzeugen=убеждать
